t_date,t_amount,t_desc,t_balance
30/06/2020,-109.99,Direct Debit 513839 IINET_LIMITED-N 20181068ccc0fb6,1070.05
30/06/2020,-153.26,Direct Debit 466856 GIO COMMERCIAL I GPM004106253,1180.04
30/06/2020,-1466.3,Transfer to CBA A/c NetBank Danibel Supplier,1333.3
30/06/2020,-209.44,OFFICEWORKS 0340 EPPING AU Tap and Pay xx3903 Value Date: 26/06/2020,2799.6
30/06/2020,-85.85,Jaycar Electronics Thomastown AU Tap and Pay xx3903 Value Date: 26/06/2020,3009.04
30/06/2020,-391.95,OFFICEWORKS 0315 BUNDOORA AU Tap and Pay xx3903 Value Date: 26/06/2020,3094.89
30/06/2020,-87.8,DAN MURPHYS 3865 EPPIN EPPING AU Tap and Pay xx3903 Value Date: 26/06/2020,3486.84
30/06/2020,-27.3,COLES 7786 LALOR AU Tap and Pay xx3903 Value Date: 27/06/2020,3574.64
30/06/2020,-38.12,ALDI STORES - EPPING EPPING AU Tap and Pay xx3903 Value Date: 26/06/2020,3601.94
30/06/2020,1158.17,Transfer From Lion Pumping Lion Pumping,3640.06
29/06/2020,-65.96,Direct Debit 279234 PAYPAL AUSTRALIA 1009474251193,2481.89
29/06/2020,-13.99,Direct Debit 279234 PAYPAL AUSTRALIA 1009470830941,2547.85
29/06/2020,1000,Transfer from NetBank,2561.84
29/06/2020,-65,COSTCO FUEL EPPING EPPING AU,1561.84
28/06/2020,-28.65,WOOLWORTHS 3171 MILL P MILL PARK AU Card xx8833,1626.84
28/06/2020,-500,Transfer to xx4217 NetBank,1655.49
27/06/2020,830,POS 43424400 27 JUN,2155.49
27/06/2020,-176,D O C CARLTON CARLTON AU Tap and Pay xx4493 Value Date: 24/06/2020,1325.49
27/06/2020,-278,OFFICEWORKS 0340 EPPING AU Tap and Pay xx3903 Value Date: 25/06/2020,1501.49
27/06/2020,-634,OFFICEWORKS 0340 EPPING AU Tap and Pay xx3903 Value Date: 25/06/2020,1779.49
26/06/2020,440,POS 43424400 26 JUN,2413.49
26/06/2020,220.36,Direct Credit 279219 PAYPAL AUSTRALIA 1009433106240,1973.49
26/06/2020,500,Transfer from CommBank app,1753.13
26/06/2020,-36.36,WWW.NETTVPLUS.COM A-F3220 WWW.NETTVPLUS CY Card xx8833 AUD 36.36 Value Date: 23/06/2020,1253.13
25/06/2020,-44.03,Direct Debit 279234 PAYPAL AUSTRALIA 1009430163031,1289.49
25/06/2020,-1000,Transfer to xx4217 NetBank,1333.52
25/06/2020,1158.17,Direct Credit 364049 LB CONCRETE JDL SOFTWARE - LB,2333.52
25/06/2020,15,Transfer from NetBank,1175.35
25/06/2020,500,Transfer from CommBank app,1160.35
25/06/2020,-500,Transfer to xx4217 NetBank,660.35
24/06/2020,780,POS 43424400 24 JUN,1160.35
24/06/2020,-120,Direct Debit 279234 PAYPAL AUSTRALIA 1009412850266,380.35
24/06/2020,-1176,HARVEY NORMAN AV/IT BAIRNSDALE AU Card xx8833 Value Date: 21/06/2020,500.35
23/06/2020,-924.15,Direct Debit 077380 DEFT PAYMENTS DEFT 20357512,1676.35
23/06/2020,-79.2,Direct Debit 279234 PAYPAL AUSTRALIA 1009408438075,2600.5
23/06/2020,-129.98,Direct Debit 279234 PAYPAL AUSTRALIA 1009408484139,2679.7
23/06/2020,-83.91,Direct Debit 279234 PAYPAL AUSTRALIA 1009407912489,2809.68
23/06/2020,-76.99,ADOBE CREATIVE CLOUD ADOBE.LY/ENAU IE Card xx8833 AUD 76.99 Value Date: 19/06/2020,2893.59
23/06/2020,-146.3,TARGETC 6586 BAIRNSDALE AU Tap and Pay xx3903 Value Date: 21/06/2020,2970.58
23/06/2020,550,Transfer From Lion Pumping Lion Monthly,3116.88
23/06/2020,1158.17,Transfer From Lion Pumping Lion Pumping,2566.88
22/06/2020,-220.36,Direct Debit 279234 PAYPAL AUSTRALIA 1009396925626,1408.71
22/06/2020,-129,Direct Debit 279234 PAYPAL AUSTRALIA 1009388409926,1629.07
20/06/2020,420,POS 43424400 20 JUN,1758.07
20/06/2020,-35,COSTCO FUEL EPPING EPPING AU,1338.07
20/06/2020,-19.35,POST THOMASTOWN POSTTH THOMASTOWN AU Card xx7776 Value Date: 17/06/2020,1373.07
19/06/2020,540,POS 43424400 19 JUN,1392.42
19/06/2020,-252.92,COSTCO WHOLESALE AUSTR EPPING AU Card xx7776,852.42
19/06/2020,-49.98,COUNTRY ROAD BUNDOORA AU Tap and Pay xx4493 Value Date: 16/06/2020,1105.34
19/06/2020,-79.99,SKECHERS BUNDOORA AU Tap and Pay xx3903 Value Date: 16/06/2020,1155.32
19/06/2020,-92.83,MILL PARK PHARMACY PL MILL PARK AU Tap and Pay xx3903 Value Date: 15/06/2020,1235.31
19/06/2020,-116.87,HOUSE ROBINS KITCHEN BUNDOORA AU Tap and Pay xx3903 Value Date: 16/06/2020,1328.14
19/06/2020,-66.96,COUNTRY ROAD BUNDOORA AU Card xx7776 Value Date: 17/06/2020,1445.01
18/06/2020,-1000,Transfer To Doni Franjo PayID Phone from CommBank App savings,1511.97
18/06/2020,740,POS 43424400 18 JUN,2511.97
18/06/2020,-255,Direct Debit 279234 PAYPAL AUSTRALIA 1009345317187,1771.97
18/06/2020,-39.21,Direct Debit 062246 CommInsure 8260620--144095342,2026.97
18/06/2020,1158.17,Direct Credit 364049 LB CONCRETE JDL SOFTWARE - LB,2066.18
18/06/2020,-26.39,THEWAYUP PTY LTD MILL PARK AU Tap and Pay xx3903 Value Date: 15/06/2020,908.01
18/06/2020,-29,JB HI FI PLENTY VALL MILL PARK AU Tap and Pay xx3903 Value Date: 15/06/2020,934.4
17/06/2020,100,POS 43424400 17 JUN,963.4
17/06/2020,-44.9,S & S FINE FOODS PTY EPPING AU Tap and Pay xx3903 Value Date: 13/06/2020,863.4
16/06/2020,-51.48,Direct Debit 062246 CommInsure 9003028--143989187,908.3
16/06/2020,-39.13,YARRAVALLEYWATER WEB MITCHAM AU Card xx8833 Value Date: 11/06/2020,959.78
16/06/2020,-130.03,PSARAKOS PTY LTD BUNDOORA AU Tap and Pay xx3903 Value Date: 11/06/2020,998.91
16/06/2020,-47.95,COLES 7786 LALOR AU Tap and Pay xx3903 Value Date: 12/06/2020,1128.94
16/06/2020,-38.33,JADE MOUNTAIN TRADING THOMASTOWN AU Tap and Pay xx3903 Value Date: 11/06/2020,1176.89
16/06/2020,-137.76,HARRIS SCARFE EPPING AU Tap and Pay xx3903 Value Date: 13/06/2020,1215.22
16/06/2020,-148.93,COSTCO WHOLESALE AUSTR EPPING AU Tap and Pay xx3903 Value Date: 13/06/2020,1352.98
16/06/2020,-1000,Transfer To Doni Franjo PayID Phone from CommBank App savings,1501.91
16/06/2020,1158.17,Transfer From Lion Pumping Lion Pumping,2501.91
15/06/2020,-1430,Direct Debit 077380 DEFT PAYMENTS DEFT 20289459,1343.74
15/06/2020,-15.5,WOOLWORTHS 3171 MILL P MILL PARK AU Card xx7776,2773.74
15/06/2020,-65,EnergyAustralia Pty NetBank BPAY 97410 10098555264979,2789.24
15/06/2020,-65,EnergyAustralia Pty NetBank BPAY 97410 10038940320839,2854.24
14/06/2020,-22.17,WOOLWORTHS 3171 MILL P MILL PARK AU Card xx7776,2919.24
13/06/2020,550,POS 43424400 13 JUN,2941.41
13/06/2020,-232.41,VODAFONE NORTH SYDNEY AU Card xx8833 Value Date: 10/06/2020,2391.41
12/06/2020,729.95,POS 43424400 12 JUN,2623.82
12/06/2020,-64.55,Direct Debit 068616 HOLLARD INSURANC HOLLAR2712171089,1893.87
12/06/2020,-200,Transfer To Doni Franjo PayID Phone from CommBank App Family,1958.42
12/06/2020,-8.64,WAFA TRADING GROUP PTY BUNDOORA AU Tap and Pay xx3903 Value Date: 09/06/2020,2158.42
11/06/2020,240,POS 43424400 11 JUN,2167.06
11/06/2020,1471.67,Direct Credit 364049 LB CONCRETE JDL SOFTWARE - LB,1927.06
11/06/2020,-18.98,JADE MOUNTAIN TRADING THOMASTOWN AU Card xx7776,455.39
11/06/2020,-1564,Transfer To Doni Franjo PayID Phone from CommBank App home rent,474.37
11/06/2020,-65.01,COSTCO FUEL EPPING EPPING AU,2038.37
11/06/2020,-14,Melb Onstreet MORELEY AU Tap and Pay xx3903 Value Date: 05/06/2020,2103.38
11/06/2020,-111.96,MILL PARK PHARMACY PL MILL PARK AU Tap and Pay xx3903 Value Date: 06/06/2020,2117.38
11/06/2020,-346.55,The Esplanade resort a Lake Entrance AU Card xx8833 Value Date: 06/06/2020,2229.34
11/06/2020,-33.44,COLES 0585 BUNDOORA AU Tap and Pay xx3903 Value Date: 09/06/2020,2575.89
10/06/2020,470.1,POS 43424400 10 JUN,2609.33
9/06/2020,-8.4,WOOLWORTHS 3140 LALOR AU Tap and Pay xx3903 Value Date: 05/06/2020,2139.23
9/06/2020,1158.17,Transfer From Lion Pumping Lion Pumping,2147.63
9/06/2020,-2.49,Direct Debit 279234 PAYPAL AUSTRALIA 1009240911130,989.46
9/06/2020,-162.2,Direct Debit 279234 PAYPAL AUSTRALIA 1009210124258,991.95
7/06/2020,-74.98,COSTCO WHOLESALE AUSTR EPPING AU Card xx7776,1154.15
7/06/2020,69.99,Refund Purchase COSTCO WHOLESALE AUSTR EPPING AU,1229.13
6/06/2020,120,POS 43424400 06 JUN,1159.14
6/06/2020,-127.48,COLES 0654 EPPING AU,1039.14
6/06/2020,-203.44,COSTCO WHOLESALE AUSTR EPPING AU Card xx7776,1166.62
6/06/2020,135,Transfer from GLENN CROCKER NetBank Glenn,1370.06
5/06/2020,500,POS 43424400 05 JUN,1235.06
5/06/2020,-306,Novotel Ibis Melb Centr alMelbourne AU,735.06
5/06/2020,-800,Transfer to xx5005 NetBank,1041.06
5/06/2020,-51.61,WOOLWORTHS 3171 MILL PARK AU Tap and Pay xx3903 Value Date: 02/06/2020,1841.06
5/06/2020,-0.89,International Transaction Fee Value Date: 02/06/2020,1892.67
5/06/2020,-29.53,WHITESPARKI 5875232235 AB CA Card xx8833 USD 20.00 Value Date: 02/06/2020,1893.56
4/06/2020,300,POS 43424400 04 JUN,1923.09
4/06/2020,-100,Direct Debit 279234 PAYPAL AUSTRALIA 1009196787701,1623.09
4/06/2020,-159.99,Direct Debit 279234 PAYPAL AUSTRALIA 1009188143237,1723.09
4/06/2020,-445,SMP*Centrecom Bundoor Bundoora03 AU,1883.08
4/06/2020,770,Transfer from CBA NetBank Hallett May,2328.08
4/06/2020,-500,LATITUDE GEM VISA NetBank BPAY 154799 6010732002049206,1558.08
4/06/2020,1158.17,Direct Credit 364049 LB CONCRETE JDL SOFTWARE - LB,2058.08
4/06/2020,-708.4,HUGO BOSS AUSTRALIA PRESTON AU Tap and Pay xx3903 Value Date: 01/06/2020,899.91
4/06/2020,-76.49,IKEA RICHMOND RICHMOND AU Tap and Pay xx3903 Value Date: 01/06/2020,1608.31
4/06/2020,-139.22,HOLLARD INSURANCE chatswood AU Card xx7776 Value Date: 01/06/2020,1684.8
3/06/2020,450,POS 43424400 03 JUN,1824.02
3/06/2020,-6.26,Direct Debit 279234 PAYPAL AUSTRALIA 1009180240229,1374.02
3/06/2020,-134.21,WOOLWORTHS 3171 MILL PARK AU Tap and Pay xx3903 Value Date: 30/05/2020,1380.28
2/06/2020,-128.7,CBA MERCHANT FEE 5353109391629396 Value Date: 31/05/2020,1514.49
2/06/2020,61.57,Transfer From LION PUMPING PTY 045LPS,1643.19
2/06/2020,-701.8,Transfer to CBA A/c NetBank Danibel Supplier,1581.62
2/06/2020,-130.43,TELSTRA BILL PAYMNT MELBOURNE AU Card xx8833 Value Date: 29/05/2020,2283.42
2/06/2020,-154.94,COSTCO WHOLESALE AUSTR EPPING AU Tap and Pay xx3903 Value Date: 28/05/2020,2413.85
2/06/2020,-3,WOOLWORTHS 3171 MILL PARK AU Tap and Pay xx3903 Value Date: 28/05/2020,2568.79
2/06/2020,-10,DISCOUNT DRUG STORES THOMASTOWN AU Card xx7776 Value Date: 29/05/2020,2571.79
2/06/2020,1158.17,Transfer From Lion Pumping Lion Pumping,2581.79
1/06/2020,-110.59,Direct Debit 513839 IINET_LIMITED-N 20152067edfb027,1423.62
31/05/2020,69,Refund Purchase WOOLWORTHS 3171 MILL PARK VIC AU,1534.21
30/05/2020,840,POS 43424400 30 MAY,1465.21
29/05/2020,110,POS 43424400 29 MAY,625.21
29/05/2020,-105,Direct Debit 279234 PAYPAL AUSTRALIA 1009125727406,515.21
29/05/2020,-13.99,Direct Debit 279234 PAYPAL AUSTRALIA 1009121400804,620.21
29/05/2020,-400,Transfer to xx5005 CommBank app Savings,634.2
29/05/2020,-65,EnergyAustralia Pty NetBank BPAY 97410 10098555264979,1034.2
29/05/2020,-65,EnergyAustralia Pty NetBank BPAY 97410 10038940320839,1099.2
29/05/2020,-800,Transfer to xx4217 NetBank,1164.2
29/05/2020,-40,OZTELL SYDNEY AU Card xx8833 Value Date: 26/05/2020,1964.2
28/05/2020,10,POS 43424400 28 MAY,2004.2
28/05/2020,-153.26,Direct Debit 466856 GIO COMMERCIAL I GPM004106253,1994.2
28/05/2020,49.98,Refund Purchase COSTCO WHOLESALE AUSTR EPPING AU,2147.46
28/05/2020,1158.17,Direct Credit 364049 LB CONCRETE JDL SOFTWARE - LB,2097.48
28/05/2020,-299.33,COSTCO WHOLESALE AUSTR EPPING AU Tap and Pay xx3903 Value Date: 25/05/2020,939.31
28/05/2020,-127.48,SCULLI BROS PTY LTD GREENSBOROUGH AU Card xx7776 Value Date: 25/05/2020,1238.64
27/05/2020,170,POS 43424400 27 MAY,1366.12
27/05/2020,-46.7,BUNNINGS 689000 MILL PARK AU Tap and Pay xx3903 Value Date: 24/05/2020,1196.12
27/05/2020,-36.36,WWW.NETTVPLUS.COM A-CF985 WWW.NETTVPLUS CY Card xx8833 AUD 36.36 Value Date: 23/05/2020,1242.82
26/05/2020,-869.05,Direct Debit 077380 DEFT PAYMENTS DEFT 20117349,1279.18
26/05/2020,-903,MWA*Centrecom Bundoora Bundoora AU Card xx8833 Value Date: 21/05/2020,2148.23
26/05/2020,-42.9,Spade Kings Pty Ltd South Morang AU Tap and Pay xx3903 Value Date: 24/05/2020,3051.23
26/05/2020,-9.68,HONG YAN GROUP PL LALOR AU Card xx7776 Value Date: 22/05/2020,3094.13
26/05/2020,-9.35,LALOR H P SEAFOODPL LALOR AU Card xx7776 Value Date: 22/05/2020,3103.81
26/05/2020,-4.95,Spade Kings Pty Ltd South Morang AU Card xx7776 Value Date: 24/05/2020,3113.16
26/05/2020,1158.17,Transfer From Lion Pumping Lion Pumping,3118.11
25/05/2020,-87.51,Direct Debit 279234 PAYPAL AUSTRALIA 1009057440781,1959.94
25/05/2020,-50.72,Direct Debit 279234 PAYPAL AUSTRALIA 1009048957745,2047.45
25/05/2020,-59.16,Direct Debit 279234 PAYPAL AUSTRALIA 1009048969151,2098.17
25/05/2020,-128.37,Direct Debit 279234 PAYPAL AUSTRALIA 1009048996806,2157.33
25/05/2020,-58.05,ALDI STORES - EPPING EPPING AU,2285.7
24/05/2020,-45.01,COSTCO FUEL EPPING EPPING AU,2343.75
23/05/2020,-1000,Transfer to xx4217 NetBank,2388.76
23/05/2020,1055,POS 43424400 23 MAY,3388.76
23/05/2020,-49,D O C CARLTON CARLTON AU Tap and Pay xx3903 Value Date: 20/05/2020,2333.76
23/05/2020,-7.72,WOOLWORTHS 3163 CARLTON AU Tap and Pay xx3903 Value Date: 20/05/2020,2382.76
23/05/2020,-2.49,WOOLWORTHS 3163 CARLTON AU Tap and Pay xx3903 Value Date: 20/05/2020,2390.48
23/05/2020,-70.4,VANILLI PTY LTD CARLTON AU Tap and Pay xx3903 Value Date: 20/05/2020,2392.97
22/05/2020,550,Transfer From Lion Pumping Lion Monthly Value Date: 23/05/2020,2463.37
22/05/2020,530,POS 43424400 22 MAY,1913.37
22/05/2020,-1000,Transfer to xx5005 CommBank app,1383.37
22/05/2020,-76.99,ADOBE CREATIVE CLOUD ADOBE.LY/ENAU IE Card xx8833 AUD 76.99 Value Date: 19/05/2020,2383.37
21/05/2020,550,POS 43424400 21 MAY,2460.36
21/05/2020,-899,Direct Debit 279234 PAYPAL AUSTRALIA 1009036467991,1910.36
21/05/2020,-567.95,Direct Debit 279234 PAYPAL AUSTRALIA 1009029663697,2809.36
21/05/2020,1158.17,Direct Credit 364049 LB CONCRETE JDL SOFTWARE - LB,3377.31
21/05/2020,-366.1,TK MAXX NORTHLAND PRESTON AU Tap and Pay xx3903 Value Date: 16/05/2020,2219.14
21/05/2020,-23.15,MILL PARK PHARMACY PL MILL PARK AU Tap and Pay xx3903 Value Date: 17/05/2020,2585.24
20/05/2020,230,POS 43424400 20 MAY,2608.39
20/05/2020,-466.59,EnergyAustralia Pty NetBank BPAY 97410 10054862335127 ShopHome Electrici,2378.39
20/05/2020,-464.96,EnergyAustralia Pty NetBank BPAY 97410 10035416593204 Electricity Shop,2844.98
20/05/2020,-20,WOOLWORTHS 3292 PRESTON AU Tap and Pay xx3903 Value Date: 16/05/2020,3309.94
19/05/2020,-39.01,Direct Debit 279234 PAYPAL AUSTRALIA 1009013593021,3329.94
19/05/2020,-49.99,Direct Debit 279234 PAYPAL AUSTRALIA 1009004518079,3368.95
19/05/2020,-39.21,Direct Debit 062246 CommInsure 8260620--143320631,3418.94
19/05/2020,-389.89,IKEA RICHMOND RICHMOND AU Tap and Pay xx3903 Value Date: 14/05/2020,3458.15
19/05/2020,1158.17,Transfer From Lion Pumping Lion Pumping,3848.04
18/05/2020,-19.8,COLES 7786 LALOR AU,2689.87
16/05/2020,645,POS 43424400 16 MAY,2709.67
16/05/2020,-37.99,COSTCO WHOLESALE AUSTR EPPING AU Card xx7776,2064.67
16/05/2020,-524.7,Transfer to CBA A/c NetBank Danibel Supplier,2102.66
16/05/2020,-29.99,COSTCO WHOLESALE AUSTR EPPING AU Tap and Pay xx3903 Value Date: 13/05/2020,2627.36
16/05/2020,-37.4,PLINE PH LALOR PLAZA LALOR AU Tap and Pay xx3903 Value Date: 12/05/2020,2657.35
16/05/2020,-46.68,WOOLWORTHS 3171 MILL PARK AU Tap and Pay xx3903 Value Date: 13/05/2020,2694.75
15/05/2020,710,POS 43424400 15 MAY,2741.43
15/05/2020,-459.95,Direct Debit 077380 DEFT PAYMENTS DEFT 20039817,2031.43
15/05/2020,-500,Transfer To Doni Franjo PayID Phone from CommBank App savings,2491.38
15/05/2020,-500,Transfer to xx5005 NetBank,2991.38
15/05/2020,-1000,Transfer to xx4217 NetBank,3491.38
15/05/2020,-23.5,MCDONALDS MILL PARK MILL PARK AU Tap and Pay xx4493 Value Date: 11/05/2020,4491.38
15/05/2020,-11.93,JOSEPHINE`S PANTRY P LALOR AU Tap and Pay xx3903 Value Date: 12/05/2020,4514.88
15/05/2020,-3.06,JOSEPHINE`S PANTRY P LALOR AU Tap and Pay xx3903 Value Date: 12/05/2020,4526.81
14/05/2020,819.95,POS 43424400 14 MAY,4529.87
14/05/2020,-51.48,Direct Debit 062246 CommInsure 9003028--143192661,3709.92
14/05/2020,1219.74,Direct Credit 364049 LB CONCRETE JDL SOFTWARE - LB,3761.4
14/05/2020,-230.64,VODAFONE NORTH SYDNEY AU Card xx8833 Value Date: 11/05/2020,2541.66
14/05/2020,-10,COLES 7786 LALOR AU Tap and Pay xx3903 Value Date: 12/05/2020,2772.3
13/05/2020,-45,COSTCO FUEL EPPING EPPING AU,2782.3
13/05/2020,-59.28,MEDITERRANEAN WHOLES BRUNSWICK AU Tap and Pay xx3903 Value Date: 10/05/2020,2827.3
13/05/2020,-39.92,S & S FINE FOODS PTY EPPING AU Tap and Pay xx3903 Value Date: 09/05/2020,2886.58
13/05/2020,-50,BOSSINI INTERNAT HEIDELBERG WE AU Card xx7776 Value Date: 10/05/2020,2926.5
12/05/2020,-64.55,Direct Debit 068616 HOLLARD INSURANC HOLLAR2692664357,2976.5
12/05/2020,-47.4,LALOR H P SEAFOODPL LALOR AU Tap and Pay xx3903 Value Date: 08/05/2020,3041.05
12/05/2020,-60.12,WOOLWORTHS 3355 EPPING AU Tap and Pay xx3903 Value Date: 08/05/2020,3088.45
12/05/2020,-26.46,PADRINO IGA PLUS LIQ THOMASTOWN AU Tap and Pay xx3903 Value Date: 08/05/2020,3148.57
12/05/2020,-88.48,HARRIS SCARFE EPPING AU Tap and Pay xx3903 Value Date: 09/05/2020,3175.03
12/05/2020,119.9,Return RESTOCK PTY LTD KEILOR PARK AU Card xx8833 Value Date: 08/05/2020,3263.51
12/05/2020,1158.17,Transfer From Lion Pumping Lion Pumping,3143.61
10/05/2020,-104.97,HARRIS SCARFE EPPING AU Card xx7776,1985.44
10/05/2020,-269.77,ALDI STORES - COBURG N COBURG NORTH AU,2090.41
9/05/2020,360,POS 43424400 09 MAY,2360.18
9/05/2020,-30,SITEGROUND HOSTING 448008620379 GB Card xx8833 AUD 30.00 Value Date: 06/05/2020,2000.18
8/05/2020,760,POS 43424400 08 MAY,2030.18
8/05/2020,-2.49,Direct Debit 279234 PAYPAL AUSTRALIA 1008886177987,1270.18
8/05/2020,-1430,Direct Debit 077380 DEFT PAYMENTS DEFT 29983966,1272.67
8/05/2020,500,Transfer from NetBank,2702.67
7/05/2020,120,POS 43424400 07 MAY,2202.67
7/05/2020,1158.17,Direct Credit 364049 LB CONCRETE JDL SOFTWARE - LB,2082.67
7/05/2020,-799,JB HI FI GREENSBOROUGH AU Tap and Pay xx3903 Value Date: 04/05/2020,924.5
7/05/2020,-54.95,JB HI FI GREENSBOROUGH AU Tap and Pay xx3903 Value Date: 04/05/2020,1723.5
7/05/2020,-45,COLES 7762 MERNDA AU Tap and Pay xx3903 Value Date: 05/05/2020,1778.45
7/05/2020,-40.97,DISCOUNT DRUG STORES THOMASTOWN AU Card xx7776 Value Date: 02/05/2020,1823.45
6/05/2020,-58,CENTRE COM SUNSHINE AU,1864.42
6/05/2020,-118.95,PSARAKOS PTY LTD BUNDOORA AU Tap and Pay xx3903 Value Date: 04/05/2020,1922.42
6/05/2020,-75.91,BUNNINGS 492000 EPPING AU Tap and Pay xx3903 Value Date: 03/05/2020,2041.37
6/05/2020,-225.25,BUNNINGS 543000 MERNDA AU Tap and Pay xx3903 Value Date: 03/05/2020,2117.28
5/05/2020,-26.57,Direct Debit 279234 PAYPAL AUSTRALIA 1008850966013,2342.53
5/05/2020,-36,Direct Debit 279234 PAYPAL AUSTRALIA 1008850892010,2369.1
5/05/2020,-39.11,Direct Debit 279234 PAYPAL AUSTRALIA 1008850965770,2405.1
5/05/2020,-34.94,Direct Debit 279234 PAYPAL AUSTRALIA 1008850793088,2444.21
5/05/2020,-29.99,Direct Debit 279234 PAYPAL AUSTRALIA 1008850813975,2479.15
5/05/2020,-184.71,Direct Debit 279234 PAYPAL AUSTRALIA 1008850610635,2509.14
5/05/2020,-59.98,WOOLWORTHS 3171 MILL PARK AU Tap and Pay xx3903 Value Date: 30/04/2020,2693.85
5/05/2020,-188.3,COSTCO WHOLESALE AUSTR EPPING AU Tap and Pay xx3903 Value Date: 30/04/2020,2753.83
5/05/2020,-40,OZTELL SYDNEY AU Card xx8833 Value Date: 30/04/2020,2942.13
5/05/2020,-205,WU 2012282496132419 180-017-3833 AU Card xx8833 Value Date: 01/05/2020,2982.13
5/05/2020,-149,Sydney Tools Pty Ltd Epping AU Tap and Pay xx3903 Value Date: 03/05/2020,3187.13
5/05/2020,-0.94,International Transaction Fee Value Date: 02/05/2020,3336.13
5/05/2020,-31.22,WHITESPARKI 5875232235 AB CA Card xx8833 USD 20.00 Value Date: 02/05/2020,3337.07
5/05/2020,-139.22,HOLLARD INSURANCE chatswood AU Card xx7776 Value Date: 01/05/2020,3368.29
5/05/2020,-19.35,POST THOMASTOWN POSTTH THOMASTOWN AU Card xx7776 Value Date: 01/05/2020,3507.51
5/05/2020,1158.17,Transfer From Lion Pumping Lion Pumping,3526.86
4/05/2020,-6.5,Direct Debit 279234 PAYPAL AUSTRALIA 1008823809986,2368.69
4/05/2020,-490,SMP*Centrecom Bundoor Bundoora03 AU,2375.19
2/05/2020,920,POS 43424400 02 MAY,2865.19
2/05/2020,-134.83,CBA MERCHANT FEE 5353109391629396 Value Date: 30/04/2020,1945.19
2/05/2020,-153.93,COSTCO WHOLESALE AUSTR EPPING AU Card xx7776,2080.02
2/05/2020,-130.43,TELSTRA BILL PAYMNT MELBOURNE AU Card xx8833 Value Date: 30/04/2020,2233.95
2/05/2020,-479.4,SITEGROUND HOSTING 448008620379 GB Card xx8833 AUD 479.40 Value Date: 29/04/2020,2364.38
1/05/2020,750,POS 43424400 01 MAY,2843.78
1/05/2020,-109.99,Direct Debit 513839 IINET_LIMITED-N 20121066fc4b62d,2093.78
1/05/2020,-803,TAX OFFICE PAYMENTS NetBank BPAY 75556 819177616490860 GST April,2203.77
1/05/2020,-31.47,MELBOURNE KEBABS & GRI THOMASTOWN AU Card xx7776,3006.77
1/05/2020,-55.95,WOOLWORTHS 3227 SOUTH MORANG AU Tap and Pay xx3903 Value Date: 28/04/2020,3038.24
1/05/2020,-198.84,DAN MURPHYS 3073 STH MORANG AU Tap and Pay xx3903 Value Date: 28/04/2020,3094.19
1/05/2020,-16.15,LALOR H P SEAFOODPL LALOR AU Card xx8833 Value Date: 28/04/2020,3293.03
1/05/2020,-12.52,COLES 7786 LALOR AU Tap and Pay xx3903 Value Date: 29/04/2020,3309.18
1/05/2020,-33.42,COLES 7705 SOUTH MORANG AU Tap and Pay xx3903 Value Date: 29/04/2020,3321.7
30/04/2020,620,POS 43424400 30 APR,3355.12
30/04/2020,1158.17,Direct Credit 364049 LB CONCRETE JDL SOFTWARE - LB,2735.12
30/04/2020,-23.06,RAMADAN (VIC) PTY LT LALOR AU Card xx8833 Value Date: 28/04/2020,1576.95
30/04/2020,-34.8,POST THOMASTOWN POSTTH THOMASTOWN AU Tap and Pay xx3903 Value Date: 27/04/2020,1600.01
29/04/2020,-9.99,Direct Debit 279234 PAYPAL AUSTRALIA 1008775580627,1634.81
29/04/2020,-24.3,KFC EPPING EPPING AU Tap and Pay xx3903 Value Date: 25/04/2020,1644.8
29/04/2020,-112.61,BUNNINGS 689000 MILL PARK AU Tap and Pay xx3903 Value Date: 26/04/2020,1669.1
29/04/2020,-94.56,BUNNINGS 689000 MILL PARK AU Tap and Pay xx3903 Value Date: 26/04/2020,1781.71
28/04/2020,-153.26,Direct Debit 466856 GIO COMMERCIAL I GPM004106253,1876.27
28/04/2020,-550,Transfer to xx5005 NetBank,2029.53
28/04/2020,-36.36,WWW.NETTVPLUS.COM A-F31C0 WWW.NETTVPLUS CY Card xx8833 AUD 36.36 Value Date: 23/04/2020,2579.53
28/04/2020,1158.17,Transfer From Lion Pumping Lion Pumping,2615.89
27/04/2020,-922.9,Transfer to CBA A/c NetBank Danibel Supplier,1457.72
27/04/2020,-37,COSTCO FUEL EPPING EPPING AU,2380.62
27/04/2020,-149.33,COSTCO WHOLESALE AUSTR EPPING AU,2417.62
25/04/2020,788.88,POS 43424400 25 APR,2566.95
25/04/2020,-143,BUNNINGS 543000 MERNDA AU Tap and Pay xx5155 Value Date: 22/04/2020,1778.07
25/04/2020,-119.9,RESTOCK PTY LTD KEILOR PARK AU Card xx8833 Value Date: 22/04/2020,1921.07
24/04/2020,-1000,Transfer to xx5005 NetBank,2040.97
24/04/2020,740,POS 43424400 24 APR,3040.97
24/04/2020,-650,Transfer to xx4217 NetBank,2300.97
24/04/2020,-176.75,SPOTLIGHT 113 MILL PARK AU Tap and Pay xx3903 Value Date: 22/04/2020,2950.97
24/04/2020,-62.52,WOOLWORTHS 3171 MILL PARK AU Tap and Pay xx3903 Value Date: 21/04/2020,3127.72
23/04/2020,640,POS 43424400 23 APR,3190.24
23/04/2020,-91.64,Direct Debit 279234 PAYPAL AUSTRALIA 1008704294961,2550.24
23/04/2020,-10.99,Direct Debit 279234 PAYPAL AUSTRALIA 1008705242364,2641.88
23/04/2020,1158.17,Direct Credit 364049 LB CONCRETE JDL SOFTWARE - LB,2652.87
23/04/2020,-62.65,WOOLWORTHS 3171 MILL PARK AU Tap and Pay xx3903 Value Date: 20/04/2020,1494.7
23/04/2020,550,Transfer From Lion Pumping Lion Monthly,1557.35
22/04/2020,500,Transfer from NetBank,1007.35
22/04/2020,-76.99,ADOBE CREATIVE CLOUD ADOBE.LY/ENAU IE Card xx8833 AUD 76.99 Value Date: 19/04/2020,507.35
21/04/2020,-1000,Transfer to xx4217 NetBank,584.34
21/04/2020,770,Transfer from CBA NetBank Hallett April 20,1584.34
21/04/2020,-1000,Transfer to xx5005 NetBank,814.34
21/04/2020,-115.9,DAN MURPHYS 3073 STH MORANG AU Tap and Pay xx3903 Value Date: 16/04/2020,1814.34
21/04/2020,-52.95,COLES 0682 BUNDOORA AU Tap and Pay xx3903 Value Date: 17/04/2020,1930.24
21/04/2020,-11,COLES 0682 BUNDOORA AU Tap and Pay xx3903 Value Date: 17/04/2020,1983.19
21/04/2020,1158.17,Transfer From Lion Pumping Lion Pumping,1994.19
20/04/2020,-33,Direct Debit 279234 PAYPAL AUSTRALIA 1008669889034,836.02
20/04/2020,-132.94,Direct Debit 279234 PAYPAL AUSTRALIA 1008650947252,869.02
20/04/2020,-39.21,Direct Debit 062246 CommInsure 8260620--142529254,1001.96
20/04/2020,5,Direct Credit 279219 PAYPAL AUSTRALIA 1008670433810,1041.17
19/04/2020,-2026,CENTRE COM SUNSHINE SUNSHINE AU,1036.17
19/04/2020,2000,Transfer from CommBank app,3062.17
19/04/2020,-500,Transfer to xx5005 CommBank app,1062.17
18/04/2020,1230,POS 43424400 18 APR,1562.17
18/04/2020,-1109,CENTRE COM SUNSHINE SUNSHINE AU,332.17
18/04/2020,-550,Transfer to xx4217 NetBank,1441.17
18/04/2020,-99,JB HI FI THOMASTOWN AU Card xx8833 Value Date: 15/04/2020,1991.17
18/04/2020,-388,HARVEY NORMAN AV/IT THOMASTOWN AU Tap and Pay xx3903 Value Date: 15/04/2020,2090.17
18/04/2020,-361.39,COSTCO WHOLESALE AUSTR EPPING AU Tap and Pay xx3903 Value Date: 15/04/2020,2478.17
18/04/2020,-72.55,WOOLWORTHS 3171 MILL PARK AU Tap and Pay xx3903 Value Date: 15/04/2020,2839.56
17/04/2020,670,POS 43424400 17 APR,2912.11
17/04/2020,-57.88,Direct Debit 279234 PAYPAL AUSTRALIA 1008634564007,2242.11
17/04/2020,-400,SMP*Centrecom Bundoor Bundoora03 AU,2299.99
17/04/2020,-12.6,DONG TIEN MARKET LALOR AU Tap and Pay xx3903 Value Date: 10/04/2020,2699.99
17/04/2020,-1.41,International Transaction Fee Value Date: 13/04/2020,2712.59
17/04/2020,-47.07,"1&1 MAIL MEDIA INC, (MAI 855-2692217 PA US Card xx8833 USD 29.99 Value Date: 13/04/2020",2714
16/04/2020,135,POS 43424400 16 APR,2761.07
16/04/2020,-48,Direct Debit 279234 PAYPAL AUSTRALIA 1008622101588,2626.07
16/04/2020,-126.61,Direct Debit 279234 PAYPAL AUSTRALIA 1008622114879,2674.07
16/04/2020,1158.17,Direct Credit 364049 LB CONCRETE JDL SOFTWARE - LB,2800.68
16/04/2020,-10.5,WOOLWORTHS 3171 MILL PARK AU Tap and Pay xx3903 Value Date: 11/04/2020,1642.51
16/04/2020,-56.91,BED BATH N TABLE BUNDOORA AU Tap and Pay xx3903 Value Date: 11/04/2020,1653.01
15/04/2020,19.95,POS 43424400 15 APR,1709.92
15/04/2020,-869.05,Direct Debit 077380 DEFT PAYMENTS DEFT 29776182,1689.97
15/04/2020,-51.48,Direct Debit 062246 CommInsure 9003028--142354917,2559.02
15/04/2020,-15,COSTCO FUEL EPPING EPPING AU,2610.5
15/04/2020,-9,WOOLWORTHS 3171 MILL PARK AU Tap and Pay xx3903 Value Date: 09/04/2020,2625.5
15/04/2020,-230.64,Vodafone Australia North Sydney AU Card xx8833 Value Date: 08/04/2020,2634.5
15/04/2020,-3.95,OFFICEWORKS 0315 BUNDOORA AU Tap and Pay xx3903 Value Date: 09/04/2020,2865.14
15/04/2020,-5.95,OFFICEWORKS 0315 BUNDOORA AU Tap and Pay xx3903 Value Date: 09/04/2020,2869.09
15/04/2020,-59.95,SHAVER SHOP EPPING EPPING AU Tap and Pay xx3903 Value Date: 11/04/2020,2875.04
15/04/2020,-145.35,COLES 0585 BUNDOORA AU Tap and Pay xx3903 Value Date: 11/04/2020,2934.99
15/04/2020,-397.72,HARRIS SCARFE EPPING AU Tap and Pay xx3903 Value Date: 11/04/2020,3080.34
15/04/2020,-99.95,HARRIS SCARFE EPPING AU Tap and Pay xx3903 Value Date: 11/04/2020,3478.06
15/04/2020,-8,OFFICEWORKS 0315 BUNDOORA AU Tap and Pay xx3903 Value Date: 13/04/2020,3578.01
15/04/2020,-17.5,COLES 0682 BUNDOORA AU Tap and Pay xx3903 Value Date: 13/04/2020,3586.01
14/04/2020,-99.95,Direct Debit 279234 PAYPAL AUSTRALIA 1008598320990,3603.51
14/04/2020,-30.89,Direct Debit 279234 PAYPAL AUSTRALIA 1008571303908,3703.46
14/04/2020,-64.55,Direct Debit 068616 HOLLARD INSURANC HOLLAR2675059414,3734.35
14/04/2020,330,Transfer From Corvette Clinic 010320c,3798.9
14/04/2020,-1000,Transfer to xx5005 NetBank,3468.9
14/04/2020,1158.17,Transfer From Lion Pumping Lion Pumping,4468.9
10/04/2020,-20,Wdl ATM CBA ATM LALOR C VIC 322603 AUS,3310.73
10/04/2020,-700,Transfer to xx4217 CommBank app,3330.73
10/04/2020,-57.2,ALDI STORES - EPPING EPPING AU Tap and Pay xx3903 Value Date: 06/04/2020,4030.73
10/04/2020,-152.96,COSTCO WHOLESALE AUSTR EPPING AU Tap and Pay xx3903 Value Date: 07/04/2020,4087.93
10/04/2020,-53.7,LALOR H P SEAFOODPL LALOR AU Tap and Pay xx3903 Value Date: 07/04/2020,4240.89
9/04/2020,-61.42,Direct Debit 279234 PAYPAL AUSTRALIA 1008539599892,4294.59
9/04/2020,-20.21,Direct Debit 279234 PAYPAL AUSTRALIA 1008539504052,4356.01
9/04/2020,2316.34,Direct Credit 364049 LB CONCRETE JDL SOFTWARE - LB,4376.22
9/04/2020,-1000,Transfer to xx5005 NetBank,2059.88
9/04/2020,-50,COSTCO FUEL EPPING EPPING AU,3059.88
9/04/2020,-53.95,WOOLWORTHS 3171 MILL PARK AU Tap and Pay xx3903 Value Date: 06/04/2020,3109.88
9/04/2020,-20,OZTELL SYDNEY AU Card xx8833 Value Date: 03/04/2020,3163.83
8/04/2020,445,POS 43424400 08 APR,3183.83
8/04/2020,-2.49,Direct Debit 279234 PAYPAL AUSTRALIA 1008534893529,2738.83
8/04/2020,-800,Transfer to xx5005 NetBank,2741.32
8/04/2020,-31.35,Jaycar Electronics Thomastown AU Tap and Pay xx3903 Value Date: 06/04/2020,3541.32
7/04/2020,300,POS 43424400 07 APR,3572.67
7/04/2020,825,Chq Dep Branch THOMASTOWN,3272.67
7/04/2020,-29.98,BUNNINGS 371000 THOMASTOWN AU Tap and Pay xx3903 Value Date: 02/04/2020,2447.67
7/04/2020,-87.5,WANAAN PTY LTD THOMASTOWN AU Tap and Pay xx3903 Value Date: 02/04/2020,2477.65
7/04/2020,-259.37,COSTCO WHOLESALE AUSTR EPPING AU Tap and Pay xx3903 Value Date: 02/04/2020,2565.15
7/04/2020,-638,Sydney Tools Pty Ltd Epping AU Tap and Pay xx3903 Value Date: 03/04/2020,2824.52
7/04/2020,-1,International Transaction Fee Value Date: 02/04/2020,3462.52
7/04/2020,-33.31,WHITESPARKI 5875232235 AB CA Card xx8833 USD 20.00 Value Date: 02/04/2020,3463.52
7/04/2020,1158.17,Transfer From Lion Pumping Lion Pumping,3496.83
6/04/2020,150,POS 43424400 06 APR,2338.66
6/04/2020,-249.53,COSTCO WHOLESALE AUSTR EPPING AU Card xx7776,2188.66
5/04/2020,-200,LATITUDE GEM VISA NetBank BPAY 154799 6010732002049206,2438.19
5/04/2020,-200,Transfer to xx4217 NetBank,2638.19
4/04/2020,1250,POS 43424400 04 APR,2838.19
4/04/2020,-154.25,COSTCO WHOLESALE AUSTR EPPING AU,1588.19
4/04/2020,-32.98,BUNNINGS 371000 THOMASTOWN AU Tap and Pay xx3903 Value Date: 01/04/2020,1742.44
4/04/2020,-83.38,IKEA RICHMOND RICHMOND AU Tap and Pay xx3903 Value Date: 01/04/2020,1775.42
4/04/2020,-139.22,HOLLARD INSURANCE chatswood AU Card xx7776 Value Date: 01/04/2020,1858.8
4/04/2020,-3.25,POST THOMASTOWN POSTTH THOMASTOWN AU Card xx7776 Value Date: 01/04/2020,1998.02
4/04/2020,-59,POST THOMASTOWN POSTTH THOMASTOWN AU Card xx7776 Value Date: 01/04/2020,2001.27
3/04/2020,590,POS 43424400 03 APR,2060.27
3/04/2020,-12.05,Direct Debit 279234 PAYPAL AUSTRALIA 1008476762567,1470.27
3/04/2020,638,Transfer from CommBank app,1482.32
3/04/2020,-1325.5,Transfer to CBA A/c NetBank Danibel Supplier,844.32
3/04/2020,-18.2,WOOLWORTHS 3171 MILL PARK AU Tap and Pay xx3903 Value Date: 01/04/2020,2169.82
2/04/2020,920,POS 43424400 02 APR,2188.02
2/04/2020,-302.99,Direct Debit 279234 PAYPAL AUSTRALIA 1008457258848,1268.02
2/04/2020,-136.99,Direct Debit 279234 PAYPAL AUSTRALIA 1008457168116,1571.01
2/04/2020,-98.85,CBA MERCHANT FEE 5353109391629396 Value Date: 31/03/2020,1708
2/04/2020,-77.01,COSTCO WHOLESALE AUSTR EPPING AU Card xx7776,1806.85
2/04/2020,-130.43,TELSTRA BILL PAYMNT MELBOURNE AU Card xx8833 Value Date: 31/03/2020,1883.86
2/04/2020,-37.24,PLINE PH LALOR PLAZA LALOR AU Tap and Pay xx3903 Value Date: 29/03/2020,2014.29
2/04/2020,-118,JB HI FI THOMASTOWN AU Card xx7776 Value Date: 30/03/2020,2051.53
1/04/2020,490,POS 43424400 01 APR,2169.53
1/04/2020,-19.99,COSTCO WHOLESALE AUSTR EPPING AU Card xx7776,1679.53
1/04/2020,-48.92,PADRINO IGA PLUS LIQ THOMASTOWN AU Card xx7776 Value Date: 30/03/2020,1699.52
31/03/2020,729.99,POS 43424400 31 MAR,1748.44
31/03/2020,-109.99,Direct Debit 513839 IINET_LIMITED-N 20090065f3f4ce9,1018.45
31/03/2020,-1430,Direct Debit 077380 DEFT PAYMENTS DEFT 29640148,1128.44
31/03/2020,-125.98,Direct Debit 279234 PAYPAL AUSTRALIA 1008436556806,2558.44
31/03/2020,-302.99,Direct Debit 279234 PAYPAL AUSTRALIA 1008434883283,2684.42
31/03/2020,-89.49,Direct Debit 279234 PAYPAL AUSTRALIA 1008436546302,2987.41
31/03/2020,-186.1,Direct Debit 279234 PAYPAL AUSTRALIA 1008434940488,3076.9
31/03/2020,-34.95,OFFICEWORKS 0307 PRESTON AU Tap and Pay xx3903 Value Date: 29/03/2020,3263
31/03/2020,-44.75,COLES 7786 LALOR AU Tap and Pay xx3903 Value Date: 29/03/2020,3297.95
31/03/2020,1158.17,Transfer From Lion Pumping Lion Pumping,3342.7
30/03/2020,970,POS 43424400 30 MAR,2184.53
30/03/2020,-111.2,Direct Debit 279234 PAYPAL AUSTRALIA 1008433624564,1214.53
30/03/2020,-153.26,Direct Debit 466856 GIO COMMERCIAL I GPM004106253,1325.73
30/03/2020,-13.99,Direct Debit 279234 PAYPAL AUSTRALIA 1008413913415,1478.99
30/03/2020,-137.85,DAN MURPHY'S 3865 EPPING VIC AU,1492.98
29/03/2020,-169.5,BUNNINGS 371000 THOMASTOWN AU,1630.83
29/03/2020,-52,COSTCO FUEL EPPING EPPING AU,1800.33
28/03/2020,-1000,Transfer to xx5005 NetBank,1852.33
28/03/2020,760,POS 43424400 28 MAR,2852.33
28/03/2020,-27.9,FASTRAC FOODSERVICE SOMERVILLE AU Card xx8833 Value Date: 26/03/2020,2092.33
28/03/2020,-40,OZTELL SYDNEY AU Card xx8833 Value Date: 25/03/2020,2120.23
28/03/2020,-29.9,NETREGISTRY 61 2 8317 614 AU Card xx8833 Value Date: 25/03/2020,2160.23
27/03/2020,850,POS 43424400 27 MAR,2190.13
27/03/2020,-957.31,Direct Debit 077380 DEFT PAYMENTS DEFT 29603644,1340.13
27/03/2020,-1000,Transfer to xx5005 NetBank,2297.44
27/03/2020,-200,Transfer to xx4217 NetBank,3297.44
27/03/2020,-200,Transfer to xx4217 NetBank,3497.44
27/03/2020,-122.9,DAN MURPHYS 3073 STH MORANG AU Tap and Pay xx3903 Value Date: 24/03/2020,3697.44
26/03/2020,390,POS 43424400 26 MAR,3820.34
26/03/2020,1158.17,Direct Credit 364049 LB CONCRETE JDL SOFTWARE - LB,3430.34
26/03/2020,-265.5,INTACT MEDIA VIC PTY PASCOEVALE AU,2272.17
26/03/2020,-7.8,WOOLWORTHS 3171 MILL PARK AU Tap and Pay xx3903 Value Date: 24/03/2020,2537.67
26/03/2020,-36.36,WWW.NETTVPLUS.COM A-47955 WWW.NETTVPLUS CY Card xx8833 AUD 36.36 Value Date: 23/03/2020,2545.47
26/03/2020,-13.16,SMP*Thomastown Fresh F Thomastown AU Card xx7776 Value Date: 23/03/2020,2581.83
25/03/2020,320,POS 43424400 25 MAR,2594.99
25/03/2020,-2.15,COLES 7786 LALOR AU,2274.99
25/03/2020,-54,THOMASTOWN W3407 THOMASTOWN AU Card xx7776,2277.14
25/03/2020,-133.98,DAN MURPHYS 3865 EPPIN EPPING AU Card xx7776,2331.14
25/03/2020,-46.2,HOME MAKE IT PTY LTD RESERVOIR AU Tap and Pay xx3903 Value Date: 23/03/2020,2465.12
25/03/2020,-102,THE GOOD GUYS THOMASTOWN AU Tap and Pay xx3903 Value Date: 22/03/2020,2511.32
25/03/2020,-46.97,THE WAREHOUSE LALOR AU Tap and Pay xx3903 Value Date: 22/03/2020,2613.32
25/03/2020,-31.94,PADRINO IGA PLUS LIQ THOMASTOWN AU Tap and Pay xx3903 Value Date: 22/03/2020,2660.29
25/03/2020,-58.56,ALDI STORES - CAMPBELL CAMPBELLFIELD AU Tap and Pay xx3903 Value Date: 21/03/2020,2692.23
24/03/2020,320,POS 43424400 24 MAR,2750.79
24/03/2020,-240.39,Direct Debit 279234 PAYPAL AUSTRALIA 1008374814318,2430.79
24/03/2020,-21.98,Direct Debit 279234 PAYPAL AUSTRALIA 1008374036974,2671.18
24/03/2020,-9.98,JOSEPHINE`S PANTRY P LALOR AU Tap and Pay xx3903 Value Date: 19/03/2020,2693.16
24/03/2020,-12.95,MICHAELS DELI PL LALOR AU Tap and Pay xx3903 Value Date: 19/03/2020,2703.14
24/03/2020,-33.71,WOOLWORTHS 3171 MILL PARK AU Tap and Pay xx3903 Value Date: 19/03/2020,2716.09
24/03/2020,-76.99,ADOBE CREATIVE CLOUD ADOBE.LY/ENAU IE Card xx8833 AUD 76.99 Value Date: 19/03/2020,2749.8
24/03/2020,-450,THE GOOD GUYS THOMASTOWN AU Tap and Pay xx3903 Value Date: 19/03/2020,2826.79
24/03/2020,-590,OFFICEWORKS 0327 CAMPBELLFIELD AU Tap and Pay xx3903 Value Date: 21/03/2020,3276.79
24/03/2020,-0.1,OFFICEWORKS 0327 CAMPBELLFIELD AU Tap and Pay xx3903 Value Date: 21/03/2020,3866.79
24/03/2020,-36.6,Jaycar Electronics Thomastown AU Tap and Pay xx3903 Value Date: 22/03/2020,3866.89
24/03/2020,-29,OFFICEWORKS 0315 BUNDOORA AU Tap and Pay xx3903 Value Date: 22/03/2020,3903.49
24/03/2020,-83.95,OFFICEWORKS 0315 BUNDOORA AU Tap and Pay xx3903 Value Date: 22/03/2020,3932.49
24/03/2020,29,Return OFFICEWORKS 0315 BUNDOORA AU Tap and Pay xx3903 Value Date: 22/03/2020,4016.44
24/03/2020,1158.17,Transfer From Lion Pumping Lion Pumping,3987.44
23/03/2020,230,POS 43424400 23 MAR,2829.27
23/03/2020,-100.12,Direct Debit 279234 PAYPAL AUSTRALIA 1008363390076,2599.27
23/03/2020,-51.2,Jaycar Electronics Thomastown AU,2699.39
23/03/2020,73.8,Refund Purchase DISCOUNT DRUG STORES THOMASTOWN VICAU,2750.59
23/03/2020,550,Transfer From Lion Pumping Lion Monthly,2676.79
22/03/2020,-202.79,COSTCO WHOLESALE AUSTR EPPING AU,2126.79
21/03/2020,459.95,POS 43424400 21 MAR,2329.58
21/03/2020,-800,Transfer to xx4217 NetBank,1869.63
21/03/2020,-5.6,WOOLWORTHS 3340 BUNDOORA AU Tap and Pay xx3903 Value Date: 18/03/2020,2669.63
20/03/2020,310,POS 43424400 20 MAR,2675.23
20/03/2020,-300,Transfer to xx4217 NetBank,2365.23
20/03/2020,770,Transfer from CBA NetBank Hallett March Apri,2665.23
20/03/2020,-73.98,PSARAKOS PTY LTD BUNDOORA AU Tap and Pay xx3903 Value Date: 18/03/2020,1895.23
20/03/2020,-8.99,CHEMIST WAREHOUSE GREENSBOROUGH AU Card xx8833 Value Date: 18/03/2020,1969.21
20/03/2020,-49.46,CHEMIST WAREHOUSE GREENSBOROUGH AU Card xx8833 Value Date: 18/03/2020,1978.2
20/03/2020,-32,YV CHOCOLATERIE YARRA GLEN AU Card xx8833 Value Date: 18/03/2020,2027.66
20/03/2020,-73.79,DISCOUNT DRUG STORES THOMASTOWN AU Tap and Pay xx3903 Value Date: 16/03/2020,2059.66
20/03/2020,-6.15,COLES 0682 BUNDOORA AU Tap and Pay xx3903 Value Date: 18/03/2020,2133.45
19/03/2020,-12.99,Direct Debit 279234 PAYPAL AUSTRALIA 1008328467509,2139.6
19/03/2020,-21.98,Direct Debit 279234 PAYPAL AUSTRALIA 1008320399537,2152.59
19/03/2020,1158.17,Direct Credit 364049 LB CONCRETE JDL SOFTWARE - LB,2174.57
19/03/2020,-43.07,THATS AMORE CHEESE P THOMASTOWN AU Card xx7776,1016.4
18/03/2020,-39.21,Direct Debit 062246 CommInsure 8260620--141730211,1059.47
18/03/2020,-169.39,COSTCO WHOLESALE AUSTR EPPING AU,1098.68
18/03/2020,-27.57,RITCHIES SUPA IGA YA YARRA GLEN AU,1268.07
18/03/2020,-90.17,YARRA VALLEY CUSTOM DIXONS CREEK AU,1295.64
18/03/2020,-9.75,COLES 0506 DIAMOND CREEKAU,1385.81
18/03/2020,-120.84,DAN MURPHYS 3865 EPPIN EPPING AU Tap and Pay xx3903 Value Date: 14/03/2020,1395.56
18/03/2020,-12.72,COLES 0585 BUNDOORA AU Tap and Pay xx3903 Value Date: 16/03/2020,1516.4
17/03/2020,-41.07,ALDI STORES - BUNDOORA BUNDOORA AU,1529.12
17/03/2020,-66.8,WOOLWORTHS 3171 MILL PARK AU Tap and Pay xx3903 Value Date: 12/03/2020,1570.19
17/03/2020,-229.16,VODAFONE NORTH SYDNEY AU Card xx8833 Value Date: 12/03/2020,1636.99
17/03/2020,1158.17,Transfer From Lion Pumping Lion Pumping,1866.15
16/03/2020,-51.48,Direct Debit 062246 CommInsure 9003028--141611548,707.98
14/03/2020,290,POS 43424400 14 MAR,759.46
14/03/2020,-60,COSTCO FUEL EPPING EPPING AU,469.46
13/03/2020,-500,Transfer to xx4217 CommBank app Value Date: 14/03/2020,529.46
13/03/2020,400,POS 43424400 13 MAR,1029.46
13/03/2020,-236,OFFICEWORKS 0315 BUNDOORA AU,629.46
12/03/2020,-64.55,Direct Debit 068616 HOLLARD INSURANC HOLLAR2655996464,865.46
12/03/2020,-532.4,Transfer to CBA A/c NetBank Danibel Supplier,930.01
12/03/2020,1158.17,Direct Credit 364049 LB CONCRETE JDL SOFTWARE - LB,1462.41
11/03/2020,100,POS 43424400 11 MAR,304.24
11/03/2020,-30,SMP*Centrecom Bundoor Bundoora03 AU,204.24
11/03/2020,-48.59,DAN MURPHY'S 3616 RICHMOND AU Tap and Pay xx3903 Value Date: 06/03/2020,234.24
10/03/2020,40,POS 43424400 10 MAR,282.83
10/03/2020,-1405,Transfer to xx5005 NetBank,242.83
10/03/2020,-11.45,KFC EPPING EPPING AU Tap and Pay xx3903 Value Date: 04/03/2020,1647.83
10/03/2020,-79.84,MATCHBOX RICHMOND AU Tap and Pay xx3903 Value Date: 06/03/2020,1659.28
10/03/2020,-59.11,OPTUS BILLING PAY MY B MACQUARIE PAR AU Card xx8833 Value Date: 06/03/2020,1739.12
10/03/2020,-12.81,CARE PARK PTY LTD MELBOURNE AU Tap and Pay xx3903 Value Date: 06/03/2020,1798.23
10/03/2020,-97.95,DAN MURPHYS 3865 EPPIN EPPING AU Tap and Pay xx3903 Value Date: 06/03/2020,1811.04
10/03/2020,-88.98,OFFICEWORKS 0315 BUNDOORA AU Tap and Pay xx3903 Value Date: 07/03/2020,1908.99
10/03/2020,-55.82,COLES 0682 BUNDOORA AU Tap and Pay xx3903 Value Date: 07/03/2020,1997.97
10/03/2020,1158.17,Transfer From Lion Pumping Lion Pumping,2053.79
9/03/2020,-2.49,Direct Debit 279234 PAYPAL AUSTRALIA 1008227342121,895.62
6/03/2020,100,POS 43424400 06 MAR,898.11
6/03/2020,-1480.17,Direct Debit 077380 DEFT PAYMENTS DEFT 29434930,798.11
6/03/2020,-36.95,HARRIS SCARFE EPPING AU Card xx8833,2278.28
5/03/2020,220,POS 43424400 05 MAR,2315.23
5/03/2020,1158.17,Direct Credit 364049 LB CONCRETE JDL SOFTWARE - LB,2095.23
5/03/2020,105.29,Transfer From Lion Pumping Lion Shortfall,937.06
5/03/2020,-34.6,BUNNINGS 371000 THOMASTOWN AU Tap and Pay xx3903 Value Date: 02/03/2020,831.77
5/03/2020,-69,FANTASTIC FURNITURE THOMASTOWN AU Tap and Pay xx3903 Value Date: 02/03/2020,866.37
5/03/2020,-0.93,International Transaction Fee Value Date: 02/03/2020,935.37
5/03/2020,-30.98,WHITESPARKI 5875232235 AB CA Card xx8833 USD 20.00 Value Date: 02/03/2020,936.3
5/03/2020,-104.87,HOLLARD INSURANCE chatswood AU Card xx7776 Value Date: 02/03/2020,967.28
4/03/2020,-25.01,COSTCO FUEL EPPING EPPING AU,1072.15
4/03/2020,-113.71,COSTCO WHOLESALE AUSTR EPPING AU Card xx7776,1097.16
4/03/2020,-17.78,COSTCO WHOLESALE AUSTR EPPING AU Card xx8833,1210.87
4/03/2020,-26.95,Jaycar Electronics Thomastown AU,1228.65
4/03/2020,-92,D O C ESPRESSO CARLTON AU Tap and Pay xx3903 Value Date: 01/03/2020,1255.6
4/03/2020,-120.99,DAN MURPHYS 3407 THOMA THOMASTOWN AU Tap and Pay xx3903 Value Date: 29/02/2020,1347.6
4/03/2020,-72.95,IKEA RICHMOND RICHMOND AU Tap and Pay xx3903 Value Date: 01/03/2020,1468.59
3/03/2020,80,POS 43424400 03 MAR,1541.54
3/03/2020,-11.31,Direct Debit 279234 PAYPAL AUSTRALIA 1008178521013,1461.54
3/03/2020,-500,LATITUDE GEM VISA NetBank BPAY 154799 6010732002049206,1472.85
3/03/2020,-181,DAN MURPHYS 3865 EPPIN EPPING AU Tap and Pay xx3903 Value Date: 27/02/2020,1972.85
3/03/2020,-13.06,S & S FINE FOODS PTY EPPING AU Tap and Pay xx3903 Value Date: 27/02/2020,2153.85
3/03/2020,-16.98,S & S FINE FOODS PTY EPPING AU Tap and Pay xx3903 Value Date: 27/02/2020,2166.91
3/03/2020,-385.25,BUNNINGS 492000 EPPING AU Tap and Pay xx3903 Value Date: 28/02/2020,2183.89
3/03/2020,1052.88,Transfer From Lion Pumping Lion Pumping,2569.14
3/03/2020,-109.99,Direct Debit 513839 IINET_LIMITED-N 2006106515b95fa,1516.26
2/03/2020,20,POS 43424400 02 MAR,1626.25
2/03/2020,-301.24,Direct Debit 279234 PAYPAL AUSTRALIA 1008170712668,1606.25
2/03/2020,-90,CBA MERCHANT FEE 5353109391629396 Value Date: 29/02/2020,1907.49
2/03/2020,-52.33,BUNNINGS 371000 THOMASTOWN AU Card xx7776,1997.49
2/03/2020,9.4,Refund Purchase BUNNINGS 371000 THOMASTOWN AU,2049.82
1/03/2020,-50.5,COSTCO FUEL EPPING EPPING AU,2040.42
1/03/2020,-18.38,BUNNINGS 539000 FAIRFIELD AU Card xx7776,2090.92
29/02/2020,80,POS 43424400 29 FEB,2109.3
29/02/2020,-130.43,TELSTRA BILL PAYMNT MELBOURNE AU Card xx8833 Value Date: 27/02/2020,2029.3
29/02/2020,-40,OZTELL SYDNEY AU Card xx8833 Value Date: 26/02/2020,2159.73
28/02/2020,280,POS 43424400 28 FEB,2199.73
28/02/2020,-153.26,Direct Debit 466856 GIO COMMERCIAL I GPM004106253,1919.73
27/02/2020,340,POS 43424400 27 FEB,2072.99
27/02/2020,-68,COSTCO FUEL EPPING EPPING AU,1732.99
27/02/2020,1052.88,Direct Credit 364049 LB CONCRETE JDL SOFTWARE - LB,1800.99
27/02/2020,-560,Transfer to xx4217 NetBank,748.11
27/02/2020,-20.56,PLINE PH LALOR PLAZA LALOR AU Tap and Pay xx3903 Value Date: 21/02/2020,1308.11
27/02/2020,-3.5,COCA-COLA AMATIL BUNDOORA AU Tap and Pay xx3903 Value Date: 22/02/2020,1328.67
26/02/2020,340,POS 43424400 26 FEB,1332.17
26/02/2020,-55.5,D DS CHARCOAL GRILL EPPING AU Card xx7776,992.17
26/02/2020,-24,PENINSULA HOT SPRG FINGAL AU Tap and Pay xx5155 Value Date: 23/02/2020,1047.67
26/02/2020,-20,PENINSULA HOT SPRG FINGAL AU Tap and Pay xx5155 Value Date: 23/02/2020,1071.67
26/02/2020,-11,PENINSULA HOT SPRI FINGAL AU Card xx8833 Value Date: 23/02/2020,1091.67
26/02/2020,-44.34,WOOLWORTHS 3340 BUNDOORA AU Tap and Pay xx5155 Value Date: 22/02/2020,1102.67
26/02/2020,-16.54,WOOLWORTHS 3340 BUNDOORA AU Tap and Pay xx5155 Value Date: 22/02/2020,1147.01
26/02/2020,-36.36,WWW.NETTVPLUS.COM A-217D0 WWW.NETTVPLUS CY Card xx8833 AUD 36.36 Value Date: 23/02/2020,1163.55
25/02/2020,80,POS 43424400 25 FEB,1199.91
25/02/2020,-40,Wdl ATM CBA ATM THOMASTOWN B VIC 317502 AUS,1119.91
25/02/2020,-141.27,EnergyAustralia Pty NetBank BPAY 97410 10054862335127 ShopHome Electrici,1159.91
25/02/2020,-1000,Transfer to xx5005 CommBank app,1301.18
25/02/2020,-16.8,COLES 7786 LALOR AU Tap and Pay xx3903 Value Date: 21/02/2020,2301.18
25/02/2020,1052.88,Transfer From Lion Pumping Lion Pumping,2317.98
24/02/2020,130,POS 43424400 24 FEB,1265.1
24/02/2020,-87.02,Direct Debit 279234 PAYPAL AUSTRALIA 1008091442101,1135.1
24/02/2020,-7.57,Direct Debit 279234 PAYPAL AUSTRALIA 1008094147704,1222.12
24/02/2020,-65.49,BUNNINGS 371000 THOMASTOWN AU Card xx7776,1229.69
23/02/2020,-62.14,RITCHIES DROMANA DROMANA AU,1295.18
22/02/2020,300,POS 43424400 22 FEB,1357.32
22/02/2020,-76.99,ADOBE CREATIVE CLOUD 1800614863 IE Card xx8833 AUD 76.99 Value Date: 19/02/2020,1057.32
21/02/2020,80,POS 43424400 21 FEB,1134.31
21/02/2020,-149.9,Direct Debit 279234 PAYPAL AUSTRALIA 1008066887511,1054.31
21/02/2020,-83.98,D'Amore Cellars Lalor AU,1204.21
21/02/2020,-560,Transfer to xx4217 NetBank,1288.19
21/02/2020,-107,SMP*Centrecom Bundoor Bundoora AU Tap and Pay xx3903 Value Date: 18/02/2020,1848.19
21/02/2020,-2.2,POST THOMASTOWN POSTTH THOMASTOWN AU Card xx7776 Value Date: 18/02/2020,1955.19
20/02/2020,550,POS 43424400 20 FEB,1957.39
20/02/2020,-90.5,D DS CHARCOAL GRILL EPPING AU Card xx7776,1407.39
20/02/2020,-500,Transfer to xx5005 NetBank,1497.89
20/02/2020,1052.88,Direct Credit 364049 LB CONCRETE JDL SOFTWARE - LB,1997.89
20/02/2020,-18.9,OFFICEWORKS 0315 BUNDOORA AU Tap and Pay xx3903 Value Date: 18/02/2020,945.01
19/02/2020,120,POS 43424400 19 FEB,963.91
18/02/2020,100,POS 43424400 18 FEB,843.91
18/02/2020,-695.23,Direct Debit 077380 DEFT PAYMENTS DEFT 29266385,743.91
18/02/2020,-39.21,Direct Debit 062246 CommInsure 8260620--140908083,1439.14
18/02/2020,-475.15,EnergyAustralia Pty NetBank BPAY 97410 10035416593204 Electricity Shop,1478.35
18/02/2020,-560,Transfer to xx4217 NetBank,1953.5
18/02/2020,-15,SMP*Centrecom Bundoor Bundoora AU Tap and Pay xx3903 Value Date: 13/02/2020,2513.5
18/02/2020,1052.88,Transfer From Lion Pumping Lion Pumping,2528.5
17/02/2020,150,POS 43424400 17 FEB,1475.62
17/02/2020,-10.99,Direct Debit 279234 PAYPAL AUSTRALIA 1008022237640,1325.62
17/02/2020,750,Transfer from CBA NetBank Hallett Feb 20,1336.61
15/02/2020,200,POS 43424400 15 FEB,586.61
14/02/2020,140,POS 43424400 14 FEB,386.61
14/02/2020,-51.48,Direct Debit 062246 CommInsure 9003028--140807610,246.61
14/02/2020,-63,COSTCO FUEL EPPING EPPING AU,298.09
14/02/2020,-200,Transfer to xx5005 CommBank app,361.09
14/02/2020,-17.9,MCDONALDS THOMASTWNII THOMASTOWN AU Tap and Pay xx3903 Value Date: 10/02/2020,561.09
14/02/2020,-1000,Transfer to xx5005 CommBank app,578.99
14/02/2020,-560,Transfer to xx4217 CommBank app,1578.99
14/02/2020,-110.59,Direct Debit 513839 IINET_LIMITED-N 200430648047bfd,2138.99
13/02/2020,270,POS 43424400 13 FEB,2249.58
13/02/2020,-420.2,Direct Debit 077380 DEFT PAYMENTS DEFT 29231683,1979.58
13/02/2020,1052.88,Direct Credit 364049 LB CONCRETE JDL SOFTWARE - LB,2399.78
13/02/2020,-41.5,CAFE LUCIO BUNDOORA AU Tap and Pay xx3903 Value Date: 11/02/2020,1346.9
13/02/2020,-64.5,FAIRFIELD PARK BOATH FAIRFIELD AU Tap and Pay xx3903 Value Date: 09/02/2020,1388.4
12/02/2020,420,POS 43424400 12 FEB,1452.9
12/02/2020,-64.55,Direct Debit 068616 HOLLARD INSURANC HOLLAR2632658718,1032.9
12/02/2020,-60,FLORALICIOUS EPPING AU Card xx7776,1097.45
12/02/2020,-111.37,VODAFONE NORTH SYDNEY AU Card xx8833 Value Date: 08/02/2020,1157.45
11/02/2020,-1564,Transfer to xx5005 CommBank app Rent,1268.82
11/02/2020,-16.45,POST THOMASTOWN POSTTH THOMASTOWN AU Card xx7776 Value Date: 06/02/2020,2832.82
11/02/2020,-44,TONDA ITAIIAN PTY LTD PRESTON AU Tap and Pay xx3903 Value Date: 06/02/2020,2849.27
11/02/2020,-5,NORTHERN HEALTH EPPING AU Tap and Pay xx3903 Value Date: 07/02/2020,2893.27
11/02/2020,-160.6,TK MAXX NORTHLAND PRESTON AU Tap and Pay xx3903 Value Date: 06/02/2020,2898.27
11/02/2020,-86,CHEVAPI GRILL SOUTH MELBOUR AU Tap and Pay xx3903 Value Date: 08/02/2020,3058.87
11/02/2020,1052.88,Transfer From Lion Pumping Lion Pumping,3144.87
10/02/2020,320,POS 43424400 10 FEB,2091.99
10/02/2020,-2.49,Direct Debit 279234 PAYPAL AUSTRALIA 1007955699080,1771.99
10/02/2020,-488.4,Transfer to CBA A/c NetBank Danibel Supplier,1774.48
8/02/2020,520,POS 43424400 08 FEB,2262.88
8/02/2020,-61,COSTCO FUEL EPPING EPPING AU,1742.88
7/02/2020,520,POS 43424400 07 FEB,1803.88
7/02/2020,-62.66,COSTCO WHOLESALE AUSTR EPPING AU Card xx7776,1283.88
7/02/2020,-500,Transfer to xx5005 NetBank,1346.54
7/02/2020,-40,OZTELL SYDNEY AU Card xx8833 Value Date: 04/02/2020,1846.54
6/02/2020,120,POS 43424400 06 FEB,1886.54
6/02/2020,-75.2,Direct Debit 279234 PAYPAL AUSTRALIA 1007930587836,1766.54
6/02/2020,1052.88,Direct Credit 364049 LB CONCRETE JDL SOFTWARE - LB,1841.74
6/02/2020,-28.4,COLES 0565 BALWYN NORTH AU Tap and Pay xx5155 Value Date: 04/02/2020,788.86
6/02/2020,-104.87,HOLLARD INSURANCE chatswood AU Card xx7776 Value Date: 03/02/2020,817.26
5/02/2020,100,POS 43424400 05 FEB,922.13
5/02/2020,-7.95,AA HIGH ST TT 3240 THOMASTOWN AU Card xx8833 Value Date: 01/02/2020,822.13
5/02/2020,-60,DAN MURPHYS 3407 THOMA THOMASTOWN AU Tap and Pay xx3903 Value Date: 31/01/2020,830.08
5/02/2020,-144.46,COSTCO WHOLESALE AUSTR EPPING AU Tap and Pay xx3903 Value Date: 02/02/2020,890.08
5/02/2020,-0.9,International Transaction Fee Value Date: 02/02/2020,1034.54
5/02/2020,-29.94,WHITESPARKI 5875232235 AB CA Card xx8833 USD 20.00 Value Date: 02/02/2020,1035.44
5/02/2020,57.99,Return COSTCO WHOLESALE AUSTR EPPING AU Tap and Pay xx3903 Value Date: 02/02/2020,1065.38
4/02/2020,15,Transfer from GLENN CROCKER NetBank Glenn Value Date: 05/02/2020,1007.39
4/02/2020,-869.05,Direct Debit 077380 DEFT PAYMENTS DEFT 29150157,992.39
4/02/2020,-150,THE MEAT AND WINE CO H HAWTHORN EASTAU,1861.44
4/02/2020,-80,COSTCO FUEL EPPING EPPING AU,2011.44
4/02/2020,69.99,Refund Purchase COSTCO WHOLESALE AUSTR EPPING AU,2091.44
4/02/2020,20,Direct Credit 122794 IINET TECHNOLOGI 2003306435121fc,2021.45
4/02/2020,870,Transfer from NetBank,2001.45
4/02/2020,-38,SMP*Centrecom Bundoor Bundoora AU Tap and Pay xx3903 Value Date: 30/01/2020,1131.45
4/02/2020,-270.8,DAN MURPHYS 3407 THOMA THOMASTOWN AU Tap and Pay xx3903 Value Date: 31/01/2020,1169.45
4/02/2020,-237.83,COSTCO WHOLESALE AUSTR EPPING AU Tap and Pay xx3903 Value Date: 31/01/2020,1440.25
4/02/2020,-500,LATITUDE GEM VISA CommBank app BPAY 154799 6010732002049206,1678.08
4/02/2020,1052.88,Transfer From Lion Pumping Lion Pumping,2178.08
3/02/2020,160,POS 43424400 03 FEB,1125.2
3/02/2020,-10.91,Direct Debit 279234 PAYPAL AUSTRALIA 1007907808351,965.2
3/02/2020,-82.4,Direct Debit 279234 PAYPAL AUSTRALIA 1007888445137,976.11
3/02/2020,100,Transfer from NetBank,1058.51
2/02/2020,-96.29,CBA MERCHANT FEE 5353109391629396 Value Date: 31/01/2020,958.51
1/02/2020,100,POS 43424400 01 FEB,1054.8
1/02/2020,-18.2,COLES 0506 DIAMOND CREEKAU,954.8
1/02/2020,-124.79,COSTCO WHOLESALE AUSTR EPPING AU Card xx8833,973
1/02/2020,-10.95,AA HIGH ST TT 3240 THOMASTOWN AU Tap and Pay xx3903 Value Date: 29/01/2020,1097.79
31/01/2020,120,POS 43424400 31 JAN,1108.74
31/01/2020,-1430,Direct Debit 077380 DEFT PAYMENTS DEFT 29122321,988.74
31/01/2020,-560,Transfer to xx4217 NetBank,2418.74
31/01/2020,-50.5,D DS CHARCOAL GRILL EPPING AU Tap and Pay xx3903 Value Date: 28/01/2020,2978.74
31/01/2020,-120.94,OFFICEWORKS 0315 BUNDOORA AU Tap and Pay xx3903 Value Date: 29/01/2020,3029.24
30/01/2020,345,POS 43424400 30 JAN,3150.18
30/01/2020,1052.88,Direct Credit 364049 LB CONCRETE JDL SOFTWARE - LB,2805.18
30/01/2020,69.76,Refund Purchase OFFICEWORKS 0315 BUNDOORA AU,1752.3
30/01/2020,-130.43,TELSTRA BILL PAYMNT MELBOURNE AU Card xx8833 Value Date: 28/01/2020,1682.54
30/01/2020,-5,NORTHERN HEALTH EPPING AU Tap and Pay xx3903 Value Date: 26/01/2020,1812.97
30/01/2020,-295,JB HI FI THOMASTOWN AU Tap and Pay xx3903 Value Date: 24/01/2020,1817.97
30/01/2020,-335,JB HI FI THOMASTOWN AU Tap and Pay xx3903 Value Date: 24/01/2020,2112.97
30/01/2020,-44.05,COLES 0682 BUNDOORA AU Tap and Pay xx3903 Value Date: 28/01/2020,2447.97
29/01/2020,360,POS 43424400 29 JAN,2492.02
29/01/2020,-153.26,Direct Debit 466856 GIO COMMERCIAL I GPM004106253,2132.02
29/01/2020,-94.16,Direct Debit 279234 PAYPAL AUSTRALIA 1007861417890,2285.28
29/01/2020,750,Transfer from CBA NetBank Hallett January 20,2379.44
29/01/2020,-560,Transfer to xx4217 CommBank app,1629.44
29/01/2020,-75.97,PSARAKOS PTY LTD BUNDOORA AU Tap and Pay xx3903 Value Date: 24/01/2020,2189.44
29/01/2020,-26,JB HI FI THOMASTOWN AU Tap and Pay xx4477 Value Date: 22/01/2020,2265.41
29/01/2020,-36.36,WWW.NETTVPLUS.COM A-55AD8 WWW.NETTVPLUS CY Card xx8833 AUD 36.36 Value Date: 23/01/2020,2291.41
29/01/2020,-89.9,VODAFONE EPPING EPPING AU Tap and Pay xx4477 Value Date: 23/01/2020,2327.77
29/01/2020,-11,JB HI FI THOMASTOWN AU Tap and Pay xx4477 Value Date: 23/01/2020,2417.67
29/01/2020,-385,3757 SUNGLASS HUT MILL PARK AU Tap and Pay xx3903 Value Date: 25/01/2020,2428.67
29/01/2020,-0.4,3757 SUNGLASS HUT MILL PARK AU Tap and Pay xx3903 Value Date: 25/01/2020,2813.67
28/01/2020,200,POS 43424400 28 JAN,2814.07
28/01/2020,1052.88,Transfer From Lion Pumping Lion Pumping,2614.07
25/01/2020,270,POS 43424400 25 JAN,1561.19
25/01/2020,135,Transfer from GLENN CROCKER NetBank Glenn,1291.19
25/01/2020,-101.9,DAN MURPHYS 3865 EPPIN EPPING AU Card xx7776,1156.19
25/01/2020,-560,Transfer to xx4217 CommBank app,1258.09
24/01/2020,710,POS 43424400 24 JAN,1818.09
24/01/2020,300,Transfer from CommBank app,1108.09
24/01/2020,-560,Transfer to xx4217 CommBank app,808.09
24/01/2020,-353.19,CENTRE COM SUNSHINE AU Card xx8833 Value Date: 21/01/2020,1368.09
23/01/2020,270,POS 43424400 23 JAN,1721.28
23/01/2020,-441.78,Direct Debit 077380 DEFT PAYMENTS DEFT 29051349,1451.28
23/01/2020,-869.05,Direct Debit 077380 DEFT PAYMENTS DEFT 29051363,1893.06
23/01/2020,-83.77,Direct Debit 279234 PAYPAL AUSTRALIA 1007809993518,2762.11
23/01/2020,-500,Transfer to xx5005 NetBank,2845.88
23/01/2020,1052.88,Direct Credit 364049 LB CONCRETE JDL SOFTWARE - LB,3345.88
22/01/2020,520,POS 43424400 22 JAN,2293
22/01/2020,-119,BIG W 0398 EPPING AU Tap and Pay xx4477 Value Date: 19/01/2020,1773
22/01/2020,-76.99,ADOBE CREATIVE CLOUD 1800614863 IE Card xx8833 AUD 76.99 Value Date: 19/01/2020,1892
21/01/2020,310,POS 43424400 21 JAN,1968.99
21/01/2020,-80,COSTCO FUEL EPPING EPPING AU,1658.99
21/01/2020,-560,Transfer to xx4217 NetBank,1738.99
21/01/2020,1052.88,Transfer From Lion Pumping Lion Pumping,2298.99
21/01/2020,-77.06,Direct Debit 279234 PAYPAL AUSTRALIA 1007785589153,1246.11
20/01/2020,150,POS 43424400 20 JAN,1323.17
20/01/2020,-92.14,Direct Debit 279234 PAYPAL AUSTRALIA 1007783974488,1173.17
20/01/2020,-39.21,Direct Debit 062246 CommInsure 8260620--140127026,1265.31
18/01/2020,-73.44,SP * IFIXIT OCEANIA CHATSWOOD AU Card xx8833 Value Date: 16/01/2020,1304.52
17/01/2020,390,POS 43424400 17 JAN,1377.96
17/01/2020,-560,Transfer to xx4217 NetBank,987.96
17/01/2020,-85,BROADWAY COMPUTERS P RESERVOIR AU Card xx8833,1547.96
17/01/2020,-180.11,WOOLWORTHS 3171 MILL PARK AU Tap and Pay xx4477 Value Date: 14/01/2020,1632.96
16/01/2020,640,POS 43424400 16 JAN,1813.07
16/01/2020,-834.8,VICROADS NetBank BPAY 216291 497581018677104 Audi Rego,1173.07
16/01/2020,1052.88,Direct Credit 364049 LB CONCRETE JDL SOFTWARE - LB,2007.87
16/01/2020,-30.6,LALOR H P SEAFOODPL LALOR AU Tap and Pay xx4477 Value Date: 11/01/2020,954.99
16/01/2020,-40,OZTELL SYDNEY AU Card xx8833 Value Date: 13/01/2020,985.59
15/01/2020,200,Transfer From ROUNTOS J*LE Digistar,1025.59
15/01/2020,-85,BROADWAY COMPUTERS P RESERVOIR AU Card xx8833,825.59
14/01/2020,40,POS 43424400 14 JAN,910.59
14/01/2020,-51.48,Direct Debit 062246 CommInsure 9003028--139962685,870.59
14/01/2020,-774.55,COSTCO WHOLESALE AUSTR EPPING AU Card xx8833,922.07
14/01/2020,-37.4,Jaycar Electronics Thomastown AU Tap and Pay xx4477 Value Date: 10/01/2020,1696.62
14/01/2020,-10.51,WOOLWORTHS 3140 LALOR AU Tap and Pay xx4477 Value Date: 09/01/2020,1734.02
14/01/2020,-88.45,WU *3082076150 SYDNEY AU Card xx8833 Value Date: 09/01/2020,1744.53
14/01/2020,1052.88,Transfer From Lion Pumping Lion Pumping,1832.98
13/01/2020,350,POS 43424400 13 JAN,780.1
13/01/2020,-64.55,Direct Debit 068616 HOLLARD INSURANC HOLLAR2609782029,430.1
13/01/2020,-20,Direct Debit 122794 IINET TECHNOLOGI 2001106388f7983,494.65
11/01/2020,70,POS 43424400 11 JAN,514.65
11/01/2020,-1400,Transfer to xx5005 NetBank,444.65
11/01/2020,-215,WU 2000888343857664 180-017-3833 AU Card xx8833 Value Date: 08/01/2020,1844.65
11/01/2020,-16.56,COLES 0604 LALOR AU Tap and Pay xx4477 Value Date: 09/01/2020,2059.65
10/01/2020,85,POS 43424400 10 JAN,2076.21
10/01/2020,-75,COSTCO FUEL EPPING EPPING AU,1991.21
10/01/2020,-75.9,DAN MURPHYS 3073 STH MORANG AU Tap and Pay xx4477 Value Date: 07/01/2020,2066.21
10/01/2020,-139.43,VODAFONE NORTH SYDNEY AU Card xx8833 Value Date: 07/01/2020,2142.11
9/01/2020,405,POS 43424400 09 JAN,2281.54
9/01/2020,1052.88,Direct Credit 364049 LB CONCRETE JDL SOFTWARE - LB,1876.54
9/01/2020,-251.94,IINET LTD N SYDNEY AU Card xx8833 Value Date: 03/01/2020,823.66
8/01/2020,84,POS 43424400 08 JAN,1075.6
8/01/2020,-2.49,Direct Debit 279234 PAYPAL AUSTRALIA 1007677133425,991.6
8/01/2020,-130.43,TELSTRA BILL PAYMNT MELBOURNE AU Card xx8833 Value Date: 03/01/2020,994.09
7/01/2020,120,POS 43424400 07 JAN,1124.52
7/01/2020,-1430,Direct Debit 077380 DEFT PAYMENTS DEFT 28903903,1004.52
7/01/2020,-34.95,Direct Debit 279234 PAYPAL AUSTRALIA 1007667778152,2434.52
7/01/2020,-60.16,Direct Debit 279234 PAYPAL AUSTRALIA 1007668796615,2469.47
7/01/2020,-371.93,OPTUS BILLING SERVICES MACQUARIE PAR AU Card xx8833 Value Date: 02/01/2020,2529.63
7/01/2020,-0.86,International Transaction Fee Value Date: 02/01/2020,2901.56
7/01/2020,-28.67,WHITESPARKI 5875232235 AB CA Card xx8833 USD 20.00 Value Date: 02/01/2020,2902.42
7/01/2020,-66,SITEGROUND HOSTING 448008620379 GB Card xx8833 AUD 66.00 Value Date: 03/01/2020,2931.09
7/01/2020,-104.87,HOLLARD INSURANCE ST LEONARDS AU Card xx7776 Value Date: 01/01/2020,2997.09
7/01/2020,1052.88,Transfer From Lion Pumping Lion Pumping,3101.96
7/01/2020,-85.98,Direct Debit 279234 PAYPAL AUSTRALIA 1007660010232,2049.08
7/01/2020,-106.14,Direct Debit 279234 PAYPAL AUSTRALIA 1007660022884,2135.06
6/01/2020,420,POS 43424400 06 JAN,2241.2
6/01/2020,-500,LATITUDE GEM VISA CommBank app BPAY 154799 6010732002049206 Gem visa,1821.2
4/01/2020,80,POS 43424400 04 JAN,2321.2
3/01/2020,180,POS 43424400 03 JAN,2241.2
3/01/2020,-10.43,Direct Debit 279234 PAYPAL AUSTRALIA 1007629927362,2061.2
3/01/2020,1052.88,Direct Credit 364049 LB CONCRETE JDL SOFTWARE - LB,2071.63
2/01/2020,300,POS 43424400 02 JAN,1018.75
2/01/2020,-90,CBA MERCHANT FEE 5353109391629396 Value Date: 31/12/2019,718.75
1/01/2020,-5.99,SUPER CHEAP AUTO THOMASTOWN AU Tap and Pay xx4477 Value Date: 27/12/2019,808.75
31/12/2019,-347.98,BUNNINGS 492000 EPPING AU Card xx8833,814.74
31/12/2019,-193.81,COSTCO WHOLESALE AUSTR EPPING AU,1162.72
31/12/2019,-207.97,SKECHERS BUNDOORA AU,1356.53
31/12/2019,-42.64,BUNNINGS 371000 THOMASTOWN AU Tap and Pay xx4477 Value Date: 26/12/2019,1564.5
31/12/2019,-89.89,COSTCO WHOLESALE AUSTR EPPING AU Tap and Pay xx4477 Value Date: 26/12/2019,1607.14
31/12/2019,-771.5,HUGO BOSS AUSTRALIA PRESTON AU Tap and Pay xx4477 Value Date: 26/12/2019,1697.03
31/12/2019,-13.83,CARE PARK PTY LTD MELBOURNE AU Card xx8833 Value Date: 28/12/2019,2468.53
31/12/2019,-6.98,International Transaction Fee Value Date: 28/12/2019,2482.36
31/12/2019,-232.53,MEDIATRANSLATION.PRO SALZBURG AT Tap and Pay xx4477 EUR 145.00 Value Date: 28/12/2019,2489.34
31/12/2019,1052.88,Transfer From Lion Pumping Lion Pumping,2721.87
30/12/2019,40,POS 43424400 30 DEC,1668.99
30/12/2019,-149.27,Direct Debit 466856 GIO COMMERCIAL I GPM004106253,1628.99
28/12/2019,-150,POS 43424400 28 DEC,1778.26
28/12/2019,-560,Transfer to xx4217 NetBank,1928.26
28/12/2019,-52.95,TK MAXX NORTHLAND PRESTON AU Tap and Pay xx4477 Value Date: 21/12/2019,2488.26
28/12/2019,-42.75,BUNNINGS 492000 EPPING AU Tap and Pay xx4477 Value Date: 23/12/2019,2541.21
28/12/2019,-39.95,TK MAXX HEIDELBERG HEIDELBERG AU Tap and Pay xx4477 Value Date: 22/12/2019,2583.96
28/12/2019,-141.75,TK MAXX HEIDELBERG HEIDELBERG AU Tap and Pay xx4477 Value Date: 21/12/2019,2623.91
28/12/2019,-36.36,WWW.NETTVPLUS.COM A-0F691 WWW.NETTVPLUS CY Card xx8833 AUD 36.36 Value Date: 23/12/2019,2765.66
28/12/2019,-111.3,MARK TRUONG PRESTON AU Tap and Pay xx4477 Value Date: 24/12/2019,2802.02
28/12/2019,-113,PRESTON SEA FOODS PT PRESTON AU Tap and Pay xx4477 Value Date: 24/12/2019,2913.32
27/12/2019,340,POS 43424400 27 DEC,3026.32
27/12/2019,1052.88,Direct Credit 364049 LB CONCRETE JDL SOFTWARE - LB,2686.32
26/12/2019,-63.01,COSTCO FUEL EPPING EPPING AU,1633.44
26/12/2019,-80,COSTCO FUEL EPPING EPPING AU,1696.45
25/12/2019,-28.98,DAN MURPHYS 3691 PREST PRESTON AU Tap and Pay xx4477 Value Date: 22/12/2019,1776.45
25/12/2019,-17.92,BUNNINGS 371000 THOMASTOWN AU Tap and Pay xx4485 Value Date: 22/12/2019,1805.43
25/12/2019,-68,CHSN PTY LTD PRESTON AU Tap and Pay xx4477 Value Date: 22/12/2019,1823.35
24/12/2019,80,POS 43424400 24 DEC,1891.35
24/12/2019,106.06,Direct Credit 122794 IINET TECHNOLOGI 19356062f67abaf,1811.35
24/12/2019,-68.49,THATS AMORE CHEESE P THOMASTOWN AU Card xx8833,1705.29
24/12/2019,-679.8,Transfer to CBA A/c NetBank Danibel Supplier,1773.78
24/12/2019,-76.99,ADOBE CREATIVE CLOUD 1800614863 IE Card xx8833 AUD 76.99 Value Date: 19/12/2019,2453.58
24/12/2019,-25,KMART 1090 PRESTON AU Tap and Pay xx4477 Value Date: 21/12/2019,2530.57
24/12/2019,-15,Infinity Hand CarWash Preston AU Card xx8833 Value Date: 22/12/2019,2555.57
24/12/2019,1052.88,Transfer From Lion Pumping Lion Pumping,2570.57
23/12/2019,150,POS 43424400 23 DEC,1517.69
23/12/2019,-83.26,Direct Debit 279234 PAYPAL AUSTRALIA 1007535513248,1367.69
22/12/2019,-104.91,COSTCO WHOLESALE AUSTR EPPING AU Card xx7776,1450.95
21/12/2019,60,POS 43424400 21 DEC,1555.86
21/12/2019,-97.9,DAN MURPHYS 3865 EPPIN EPPING AU Tap and Pay xx4477 Value Date: 18/12/2019,1495.86
21/12/2019,-7,Melb Onstreet MORELEY AU Tap and Pay xx4477 Value Date: 17/12/2019,1593.76
20/12/2019,520,POS 43424400 20 DEC,1600.76
20/12/2019,-1000,Transfer to xx5005 NetBank,1080.76
20/12/2019,-560,Transfer to xx4217 NetBank,2080.76
19/12/2019,230,POS 43424400 19 DEC,2640.76
19/12/2019,1052.88,Direct Credit 364049 LB CONCRETE JDL SOFTWARE - LB,2410.76
19/12/2019,-1247,HUGO BOSS AUSTRALIA PRESTON AU Tap and Pay xx4477 Value Date: 15/12/2019,1357.88
18/12/2019,270,POS 43424400 18 DEC,2604.88
18/12/2019,-113.72,Direct Debit 279234 PAYPAL AUSTRALIA 1007482115026,2334.88
18/12/2019,-39.21,Direct Debit 062246 CommInsure 8260620--139329452,2448.6
18/12/2019,-323,JB HI FI THOMASTOWN AU,2487.81
18/12/2019,-168.4,COLES 7786 LALOR AU Tap and Pay xx4477 Value Date: 16/12/2019,2810.81
17/12/2019,260,POS 43424400 17 DEC,2979.21
17/12/2019,750,Transfer from CBA NetBank Hallett Dec,2719.21
17/12/2019,-550,Transfer to xx5005 NetBank,1969.21
17/12/2019,-500.5,Transfer to CBA A/c NetBank Danibel Supplier,2519.21
17/12/2019,1052.88,Transfer From Lion Pumping Lion Pumping,3019.71
16/12/2019,220,POS 43424400 16 DEC,1966.83
16/12/2019,-51.48,Direct Debit 062246 CommInsure 9003028--139210233,1746.83
16/12/2019,-169.53,COSTCO WHOLESALE AUSTR EPPING AU,1798.31
15/12/2019,500,Transfer from CommBank app,1967.84
14/12/2019,150,POS 43424400 14 DEC,1467.84
13/12/2019,185,POS 43424400 13 DEC,1317.84
13/12/2019,-87,JB HI FI THOMASTOWN AU Tap and Pay xx4477 Value Date: 09/12/2019,1132.84
12/12/2019,100,POS 43424400 12 DEC,1219.84
12/12/2019,-64.55,Direct Debit 068616 HOLLARD INSURANC HOLLAR2588240526,1119.84
12/12/2019,-166.32,Direct Debit 279234 PAYPAL AUSTRALIA 1007427235130,1184.39
12/12/2019,-1000,Transfer to xx5005 NetBank,1350.71
12/12/2019,-1000,Transfer to xx4217 NetBank,2350.71
12/12/2019,1052.88,Direct Credit 364049 LB CONCRETE JDL SOFTWARE - LB,3350.71
12/12/2019,-24.88,BUNNINGS 371000 THOMASTOWN AU Tap and Pay xx4477 Value Date: 09/12/2019,2297.83
12/12/2019,-91.25,COSTCO WHOLESALE AUSTR EPPING AU Tap and Pay xx4477 Value Date: 09/12/2019,2322.71
12/12/2019,-97.98,DAN MURPHYS 3407 THOMA THOMASTOWN AU Tap and Pay xx4477 Value Date: 09/12/2019,2413.96
11/12/2019,70,POS 43424400 11 DEC,2511.94
11/12/2019,-1500,Transfer to xx5005 NetBank,2441.94
11/12/2019,-46.95,NETREGISTRY 61 2 8317 614 AU Card xx8833 Value Date: 08/12/2019,3941.94
11/12/2019,-104.5,VODAFONE NORTH SYDNEY AU Card xx8833 Value Date: 07/12/2019,3988.89
11/12/2019,500,Transfer From LION PUMPING LION PUMPING,4093.39
10/12/2019,490,POS 43424400 10 DEC,3593.39
10/12/2019,1052.88,Transfer From Lion Pumping Lion Pumping,3103.39
9/12/2019,300,POS 43424400 09 DEC,2050.51
9/12/2019,-955.96,Direct Debit 077380 DEFT PAYMENTS DEFT 28642505,1750.51
9/12/2019,-85,COSTCO FUEL EPPING EPPING AU,2706.47
7/12/2019,230,POS 43424400 07 DEC,2791.47
5/12/2019,1052.88,Direct Credit 364049 LB CONCRETE JDL SOFTWARE - LB,2561.47
5/12/2019,-204.48,AUTHORIZATION SYDNEY AU Card xx8833 Value Date: 02/12/2019,1508.59
5/12/2019,-40,OZTELL SYDNEY AU Card xx8833 Value Date: 02/12/2019,1713.07
5/12/2019,-0.89,International Transaction Fee Value Date: 02/12/2019,1753.07
5/12/2019,-29.61,WHITESPARKI 5875232235 AB CA Card xx8833 USD 20.00 Value Date: 02/12/2019,1753.96
5/12/2019,-104.87,HOLLARD INSURANCE ST LEONARDS AU Card xx7776 Value Date: 02/12/2019,1783.57
4/12/2019,500,Transfer From LION PUMPING LION PUMPING,1888.44
3/12/2019,-100,Direct Debit 279240 PAYPAL AUSTRALIA 5N5J2AUUPVY48,1388.44
3/12/2019,-580,Transfer to xx4217 NetBank,1488.44
3/12/2019,1052.88,Transfer From Lion Pumping Lion Pumping,2068.44
2/12/2019,-90,CBA MERCHANT FEE 5353109391629396 Value Date: 30/11/2019,1015.56
1/12/2019,-500,Transfer to xx5005 CommBank app,1105.56
30/11/2019,-1485.83,Aston.Commercial NetBank BPAY 81273 10165207 Rent and Rates,1605.56
30/11/2019,750,Transfer from CBA NetBank Hallettstone Nov,3091.39
30/11/2019,-109.47,OPTUS BILLING SERVICES MACQUARIE PAR AU Card xx8833 Value Date: 27/11/2019,2341.39
29/11/2019,-200,Transfer to xx5005 CommBank app,2450.86
29/11/2019,-130.43,TELSTRA BILL PAYMNT MELBOURNE AU Card xx8833 Value Date: 27/11/2019,2650.86
29/11/2019,-74,JB HI FI THOMASTOWN AU Card xx8833 Value Date: 25/11/2019,2781.29
28/11/2019,-149.27,Direct Debit 466856 GIO COMMERCIAL I GPM004106253,2855.29
28/11/2019,-51.64,Direct Debit 062246 CommInsure 9003028--138773785,3004.56
28/11/2019,1052.88,Direct Credit 364049 LB CONCRETE JDL SOFTWARE - LB,3056.2
27/11/2019,-83,LOOKING4PARKING LIMITE LEEDS GB Card xx8833 AUD 83.00 Value Date: 24/11/2019,2003.32
27/11/2019,-36.36,WWW.NETTVPLUS.COM A-87F07 WWW.NETTVPLUS CY Card xx8833 AUD 36.36 Value Date: 23/11/2019,2086.32
27/11/2019,500,Transfer From LION PUMPING LION PUMPING,2122.68
26/11/2019,-145,WOOLWORTHS 3171 MILL PARK AU Tap and Pay xx4477 Value Date: 21/11/2019,1622.68
26/11/2019,-83.45,MARK TRUONG PRESTON AU Card xx8833 Value Date: 22/11/2019,1767.68
26/11/2019,-92.89,DAN MURPHYS 3865 EPPIN EPPING AU Tap and Pay xx4477 Value Date: 22/11/2019,1851.13
26/11/2019,1052.88,Transfer From Lion Pumping Lion Pumping,1944.02
25/11/2019,80,POS 43424400 25 NOV,891.14
25/11/2019,-84.48,Direct Debit 279234 PAYPAL AUSTRALIA 1007222027698,811.14
24/11/2019,80,POS 43424400 23 NOV Value Date: 23/11/2019,895.62
23/11/2019,-59,JB HI FI THOMASTOWN AU Tap and Pay xx4477 Value Date: 19/11/2019,815.62
23/11/2019,-19.98,OFFICEWORKS 0315 BUNDOORA AU Tap and Pay xx4477 Value Date: 21/11/2019,874.62
23/11/2019,-7,COLES EXPRESS 6976 GLEN WAVERLEY AU Tap and Pay xx4477 Value Date: 21/11/2019,894.6
22/11/2019,300,POS 43424400 22 NOV,901.6
22/11/2019,-1079.98,COSTCO WHOLESALE AUSTR EPPING AU,601.6
22/11/2019,-297.99,OFFICEWORKS 0307 PRESTON AU,1681.58
22/11/2019,-20.7,BUNNINGS 371000 THOMASTOWN AU Tap and Pay xx4477 Value Date: 19/11/2019,1979.57
22/11/2019,-7.96,BUNNINGS 371000 THOMASTOWN AU Tap and Pay xx4477 Value Date: 19/11/2019,2000.27
22/11/2019,-76.99,ADOBE CREATIVE CLOUD 1800614863 IE Card xx8833 AUD 76.99 Value Date: 19/11/2019,2008.23
21/11/2019,280,POS 43424400 21 NOV,2085.22
21/11/2019,-10.99,Direct Debit 279234 PAYPAL AUSTRALIA 1007202542761,1805.22
21/11/2019,-500,Transfer to xx4217 NetBank,1816.21
21/11/2019,1052.88,Direct Credit 364049 LB CONCRETE JDL SOFTWARE - LB,2316.21
21/11/2019,-21.81,BUNNINGS 371000 THOMASTOWN AU Tap and Pay xx4477 Value Date: 18/11/2019,1263.33
20/11/2019,360,POS 43424400 20 NOV,1285.14
20/11/2019,-98.35,Direct Debit 279234 PAYPAL AUSTRALIA 1007195693615,925.14
20/11/2019,-300,LATITUDE GEM VISA NetBank BPAY 154799 6010732002049206 Gem Visa,1023.49
20/11/2019,500,Transfer From LION PUMPING LION PUMPING,1323.49
20/11/2019,-36,COLES 7786 LALOR AU Tap and Pay xx4477 Value Date: 18/11/2019,823.49
19/11/2019,-39.31,Direct Debit 062246 CommInsure 8260620--138530576,859.49
19/11/2019,-241.3,Jaycar Electronics Thomastown AU,898.8
19/11/2019,-570.9,Transfer to CBA A/c NetBank Danibel Supplier,1140.1
19/11/2019,-12.58,PADRINO IGA PLUS LIQ THOMASTOWN AU Tap and Pay xx4477 Value Date: 14/11/2019,1711
19/11/2019,-69.03,BUNNINGS 492000 EPPING AU Tap and Pay xx4477 Value Date: 14/11/2019,1723.58
19/11/2019,-51.39,BUNNINGS 492000 EPPING AU Tap and Pay xx4477 Value Date: 15/11/2019,1792.61
19/11/2019,-240,IKEA RICHMOND RICHMOND AU Tap and Pay xx4477 Value Date: 15/11/2019,1844
19/11/2019,-158.91,COLES 7786 LALOR AU Tap and Pay xx4477 Value Date: 17/11/2019,2084
19/11/2019,1052.88,Transfer From Lion Pumping Lion Pumping,2242.91
18/11/2019,140,POS 43424400 18 NOV,1190.03
17/11/2019,-12.98,COSTCO WHOLESALE AUSTR EPPING AU,1050.03
16/11/2019,350,POS 43424400 16 NOV,1063.01
16/11/2019,-400,Transfer to xx4217 NetBank,713.01
16/11/2019,-86,COSTCO FUEL EPPING EPPING AU,1113.01
16/11/2019,-73.89,IKEA RICHMOND RICHMOND AU Card xx8833 Value Date: 13/11/2019,1199.01
16/11/2019,-30,IKEA RICHMOND RICHMOND AU Card xx8833 Value Date: 13/11/2019,1272.9
16/11/2019,-243,OFFICEWORKS 0340 EPPING AU Tap and Pay xx4477 Value Date: 14/11/2019,1302.9
15/11/2019,-32.8,Direct Debit 279234 PAYPAL AUSTRALIA 1007147896201,1545.9
15/11/2019,-419.99,COSTCO WHOLESALE AUSTR EPPING AU,1578.7
15/11/2019,-24.6,COLES 0585 BUNDOORA AU,1998.69
15/11/2019,-100,Transfer to xx5005 CommBank app,2023.29
15/11/2019,60,Direct Credit 403697 AMEX GR 60.00 8032007957,2123.29
15/11/2019,-100,D O C CARLTON CARLTON AU Card xx8833 Value Date: 12/11/2019,2063.29
14/11/2019,100,POS 43424400 14 NOV,2163.29
14/11/2019,1052.88,Direct Credit 364049 LB CONCRETE JDL SOFTWARE - LB,2063.29
13/11/2019,250,POS 43424400 13 NOV,1010.41
13/11/2019,-119.24,Direct Debit 122794 IINET TECHNOLOGI 19315061bb705f4,760.41
13/11/2019,-23.62,Direct Debit 279234 PAYPAL AUSTRALIA 1007123695321,879.65
13/11/2019,-30,SPOTLIGHT 113 MILL PARK AU Tap and Pay xx4477 Value Date: 10/11/2019,903.27
13/11/2019,-215.92,DAN MURPHYS 3865 EPPIN EPPING AU Tap and Pay xx4477 Value Date: 09/11/2019,933.27
12/11/2019,470,POS 43424400 12 NOV,1149.19
12/11/2019,-72.32,Direct Debit 068616 HOLLARD INSURANC HOLLAR2563855651,679.19
12/11/2019,-78,KMART 1391 RESERVOIR AU,751.51
12/11/2019,-1000,Transfer to xx4217 NetBank,829.51
12/11/2019,-21.44,BUNNINGS 371000 THOMASTOWN AU Tap and Pay xx4477 Value Date: 07/11/2019,1829.51
12/11/2019,-93.85,BUNNINGS 371000 THOMASTOWN AU Tap and Pay xx4477 Value Date: 07/11/2019,1850.95
12/11/2019,-45.9,BUNNINGS 371000 THOMASTOWN AU Tap and Pay xx4477 Value Date: 08/11/2019,1944.8
12/11/2019,-33.3,BUNNINGS 492000 EPPING AU Tap and Pay xx4477 Value Date: 08/11/2019,1990.7
12/11/2019,-59,BUNNINGS 492000 EPPING AU Tap and Pay xx4477 Value Date: 08/11/2019,2024
12/11/2019,-106.03,VODAFONE NORTH SYDNEY AU Card xx8833 Value Date: 08/11/2019,2083
12/11/2019,1052.88,Transfer From Lion Pumping Lion Pumping,2189.03
11/11/2019,-4.2,Direct Debit 279234 PAYPAL AUSTRALIA 1007104102760,1136.15
11/11/2019,-41,CENTRE COM SUNSHINE AU,1140.35
11/11/2019,-165,CENTRE COM SUNSHINE SUNSHINE AU,1181.35
11/11/2019,-1814,CENTRE COM SUNSHINE AU,1346.35
11/11/2019,2000,Transfer from CommBank app,3160.35
11/11/2019,-150,Transfer to xx5005 NetBank,1160.35
11/11/2019,-1000,Transfer to xx5005 NetBank,1310.35
10/11/2019,-156.56,COSTCO WHOLESALE AUSTR EPPING AU,2310.35
9/11/2019,440,POS 43424400 09 NOV,2466.91
8/11/2019,-98.56,BUNNINGS 689000 MILL PARK AU Tap and Pay xx4477 Value Date: 05/11/2019,2026.91
8/11/2019,-130.54,OFFICEWORKS 0340 EPPING AU Tap and Pay xx4477 Value Date: 06/11/2019,2125.47
7/11/2019,-1114.74,IKEA RICHMOND RICHMOND AU,2256.01
7/11/2019,1052.88,Direct Credit 364049 LB CONCRETE JDL SOFTWARE - LB,3370.75
7/11/2019,400,Transfer From Corvette Clinic inv011019c,2317.87
7/11/2019,-216,OFFICEWORKS 0340 EPPING AU,1917.87
6/11/2019,680,POS 43424400 06 NOV,2133.87
5/11/2019,-80.01,COSTCO FUEL EPPING EPPING AU,1453.87
5/11/2019,-104.87,HOLLARD INSURANCE ST LEONARDS AU Card xx7776 Value Date: 01/11/2019,1533.88
5/11/2019,-59,JB HI FI THOMASTOWN AU Card xx8833 Value Date: 31/10/2019,1638.75
5/11/2019,-72.48,OFFICEWORKS 0340 EPPING AU Tap and Pay xx4477 Value Date: 02/11/2019,1697.75
5/11/2019,-0.87,International Transaction Fee Value Date: 02/11/2019,1770.23
5/11/2019,-29.06,WHITESPARKI 5875232235 AB CA Card xx8833 USD 20.00 Value Date: 02/11/2019,1771.1
5/11/2019,1052.88,Transfer From Lion Pumping Lion Pumping,1800.16
4/11/2019,240,POS 43424400 04 NOV,747.28
4/11/2019,-10.59,Direct Debit 279234 PAYPAL AUSTRALIA 1007038257059,507.28
4/11/2019,-1.49,Direct Debit 279234 PAYPAL AUSTRALIA 1007025195673,517.87
4/11/2019,-40.21,Direct Debit 279234 PAYPAL AUSTRALIA 1007029624414,519.36
2/11/2019,120,POS 43424400 02 NOV,559.57
2/11/2019,-98.55,CBA MERCHANT FEE 5353109391629396 Value Date: 31/10/2019,439.57
2/11/2019,-19.98,BUNNINGS 371000 THOMASTOWN AU Card xx8833,538.12
2/11/2019,-569.99,COSTCO WHOLESALE AUSTR EPPING AU,558.1
1/11/2019,685,POS 43424400 01 NOV,1128.09
1/11/2019,-1850.2,Direct Debit 077380 DEFT PAYMENTS DEFT 28329598,443.09
1/11/2019,-200,Transfer to xx4217 NetBank,2293.29
1/11/2019,-76,COSTCO FUEL EPPING EPPING AU,2493.29
1/11/2019,-100,Transfer to xx5005 NetBank,2569.29
31/10/2019,-10.99,Direct Debit 279234 PAYPAL AUSTRALIA 1007010280846,2669.29
31/10/2019,-4.99,Direct Debit 279234 PAYPAL AUSTRALIA 1007010422263,2680.28
31/10/2019,410,POS 43424400 31 OCT,2685.27
31/10/2019,-478.5,Transfer to CBA A/c NetBank Danibel Supplier,2275.27
31/10/2019,-35.09,Direct Debit 062246 CommInsure 8260620--137717956,2753.77
31/10/2019,1052.88,Direct Credit 364049 LB CONCRETE JDL SOFTWARE - LB,2788.86
31/10/2019,-150.2,COSTCO WHOLESALE AUSTR EPPING AU,1735.98
31/10/2019,-130.86,TELSTRA BILL PAYMNT MELBOURNE AU Card xx8833 Value Date: 29/10/2019,1886.18
31/10/2019,-109.86,OPTUS BILLING SERVICES MACQUARIE PAR AU Card xx8833 Value Date: 29/10/2019,2017.04
31/10/2019,-131.88,DAN MURPHYS 3407 THOMA THOMASTOWN AU Tap and Pay xx4477 Value Date: 29/10/2019,2126.9
31/10/2019,-52.48,DAN MURPHYS 3407 THOMA THOMASTOWN AU Tap and Pay xx4477 Value Date: 29/10/2019,2258.78
31/10/2019,-149,AMART FURNITURE SOUTH MORANG AU Card xx7776 Value Date: 27/10/2019,2311.26
30/10/2019,500,Transfer From LION PUMPING LION PUMPING,2460.26
30/10/2019,-202.21,IKEA RICHMOND RICHMOND AU Tap and Pay xx4477 Value Date: 26/10/2019,1960.26
30/10/2019,-234.98,AMAZON MKTPLC AU SYDNEY SOUTH AU Card xx8833 Value Date: 26/10/2019,2162.47
29/10/2019,220,POS 43424400 29 OCT,2397.45
29/10/2019,-499,Direct Debit 279234 PAYPAL AUSTRALIA 1006993999313,2177.45
29/10/2019,-149.27,Direct Debit 466856 GIO COMMERCIAL I GPM004106253,2676.45
29/10/2019,-16.2,WILSON PARKING 197 SOUTHBANK AU Card xx8833 Value Date: 24/10/2019,2825.72
29/10/2019,-209.93,INET LTD N SYDNEY AU Card xx8833 Value Date: 25/10/2019,2841.92
29/10/2019,1052.88,Transfer From Lion Pumping Lion Pumping,3051.85
28/10/2019,100,POS 43424400 28 OCT,1998.97
28/10/2019,-42.9,Direct Debit 279234 PAYPAL AUSTRALIA 1006969975353,1898.97
28/10/2019,-266,OFFICEWORKS 0340 EPPING AU,1941.87
26/10/2019,340,POS 43424400 26 OCT,2207.87
26/10/2019,-36.36,WWW.NETTVPLUS.COM A-3F4BB WWW.NETTVPLUS CY Card xx8833 AUD 36.36 Value Date: 23/10/2019,1867.87
25/10/2019,450,POS 43424400 25 OCT,1904.23
25/10/2019,-25.95,Direct Debit 279234 PAYPAL AUSTRALIA 1006958821096,1454.23
25/10/2019,-1000,Transfer to xx5005 NetBank,1480.18
25/10/2019,-580,Transfer to xx4217 NetBank,2480.18
25/10/2019,-474.07,EnergyAustralia Pty NetBank BPAY 97410 10035416593204 Electricity Shop,3060.18
24/10/2019,120,POS 43424400 24 OCT,3534.25
24/10/2019,1052.88,Direct Credit 364049 LB CONCRETE JDL SOFTWARE - LB,3414.25
24/10/2019,-80.01,COSTCO FUEL EPPING EPPING AU,2361.37
24/10/2019,-8.95,POST THOMASTOWN POSTTH THOMASTOWN AU Card xx7776 Value Date: 21/10/2019,2441.38
24/10/2019,-2,POST THOMASTOWN POSTTH THOMASTOWN AU Card xx7776 Value Date: 21/10/2019,2450.33
23/10/2019,-333,THE MEAT AND WINE CO S SOUTHBANK AU,2452.33
23/10/2019,-83.74,Direct Debit 279234 PAYPAL AUSTRALIA 1006940795020,2785.33
23/10/2019,750,Transfer from CBA NetBank SEO,2869.07
22/10/2019,420,POS 43424400 22 OCT,2119.07
22/10/2019,50,Sorry from CBA,1699.07
22/10/2019,-250,Transfer to xx5005 NetBank,1649.07
22/10/2019,-36.99,D'Amore Cellars Lalor AU Tap and Pay xx4477 Value Date: 18/10/2019,1899.07
22/10/2019,-76.99,ADOBE CREATIVE CLOUD 1800614863 IE Card xx8833 AUD 76.99 Value Date: 19/10/2019,1936.06
22/10/2019,1052.88,Transfer From Lion Pumping Lion Pumping,2013.05
21/10/2019,-330,Direct Debit 077380 DEFT PAYMENTS DEFT 28220838,960.17
21/10/2019,-120.99,Direct Debit 279234 PAYPAL AUSTRALIA 1006907165256,1290.17
21/10/2019,-80,BROADWAY COMPUTERS P RESERVOIR AU Card xx8833,1411.16
21/10/2019,-300,GEM VISA CARD NetBank BPAY 154799 6010732002049206,1491.16
21/10/2019,-580,Transfer to xx4217 NetBank,1791.16
21/10/2019,1052.88,Direct Credit 364049 LB CONCRETE JDL SOFTWARE - LB,2371.16
19/10/2019,400,POS 43424400 19 OCT,1318.28
18/10/2019,130,POS 43424400 18 OCT,918.28
18/10/2019,-118.23,THOMASTOWN W3407 THOMASTOWN AU Card xx8833,788.28
18/10/2019,-1440,Transfer to xx5005 NetBank,906.51
18/10/2019,360,POS 43424400 17 OCT Value Date: 17/10/2019,2346.51
17/10/2019,-11.5,BUNNINGS 371000 THOMASTOWN AU Card xx8833,1986.51
17/10/2019,-230,BROADWAY COMPUTERS P RESERVOIR AU,1998.01
16/10/2019,320,POS 43424400 16 OCT,2228.01
16/10/2019,-14.95,Direct Debit 279234 PAYPAL AUSTRALIA 1006880367873,1908.01
15/10/2019,105,POS 43424400 15 OCT,1922.96
15/10/2019,-402.6,Transfer to CBA A/c NetBank Danibel Supplier,1817.96
15/10/2019,1052.88,Transfer From Lion Pumping Lion Pumping,2220.56
14/10/2019,200,POS 43424400 14 OCT,1167.68
14/10/2019,-72.32,Direct Debit 068616 HOLLARD INSURANC HOLLAR2541136267,967.68
14/10/2019,-55.51,Direct Debit 279234 PAYPAL AUSTRALIA 1006846096994,1040
14/10/2019,-22.21,Direct Debit 279234 PAYPAL AUSTRALIA 1006846275200,1095.51
14/10/2019,-116.34,Direct Debit 122794 IINET TECHNOLOGI 19284060d014f09,1117.72
14/10/2019,-130,COLES 7786 LALOR AU,1234.06
12/10/2019,480,POS 43424400 12 OCT,1364.06
12/10/2019,45,Transfer from GLENN CROCKER NetBank Glenn,884.06
12/10/2019,-154.22,COSTCO WHOLESALE AUSTR EPPING AU,839.06
12/10/2019,-16.3,MCDONALDS EPPING EPPING AU Card xx8833 Value Date: 08/10/2019,993.28
11/10/2019,150,POS 43424400 11 OCT,1009.58
11/10/2019,-1580,Transfer to xx4217 NetBank,859.58
11/10/2019,-99.5,YARRA CITY COUNCIL ABBOTSFORD AU Card xx8833 Value Date: 09/10/2019,2439.58
11/10/2019,-31.9,SWITZER FINANCIAL GROU SYDNEY AU Card xx8833 Value Date: 10/10/2019,2539.08
10/10/2019,1052.88,Direct Credit 364049 LB CONCRETE JDL SOFTWARE - LB,2570.98
10/10/2019,-118,OFFICEWORKS 0340 EPPING AU,1518.1
10/10/2019,-736,OPSM 1032 EPPING AU,1636.1
10/10/2019,-157.3,FRESH START (VIC) PT MILL PARK AU Card xx8833 Value Date: 07/10/2019,2372.1
10/10/2019,-111.21,Vodafone Australia North Sydney AU Card xx8833 Value Date: 07/10/2019,2529.4
9/10/2019,440,POS 43424400 09 OCT,2640.61
9/10/2019,-26.95,Direct Debit 279234 PAYPAL AUSTRALIA 1006821823725,2200.61
9/10/2019,-22.9,Direct Debit 279234 PAYPAL AUSTRALIA 1006821833644,2227.56
9/10/2019,-2.7,Direct Debit 279234 PAYPAL AUSTRALIA 1006821823615,2250.46
9/10/2019,-4.26,Direct Debit 279234 PAYPAL AUSTRALIA 1006819889239,2253.16
9/10/2019,-500,GEM VISA CARD NetBank BPAY 154799 6010732002049206,2257.42
9/10/2019,-45.85,The Cheesecake Shop Epping AU Card xx7776 Value Date: 07/10/2019,2757.42
8/10/2019,280,POS 43424400 08 OCT,2803.27
8/10/2019,-80.98,D'Amore Cellars Lalor AU,2523.27
8/10/2019,-40.01,COSTCO WHOLESALE AUSTR EPPING AU,2604.25
8/10/2019,-1000,Transfer to xx5005 NetBank,2644.26
8/10/2019,1052.88,Transfer From Lion Pumping Lion Pumping,3644.26
7/10/2019,170,POS 43424400 07 OCT,2591.38
7/10/2019,-10.99,Direct Debit 279234 PAYPAL AUSTRALIA 1006784907029,2421.38
7/10/2019,1052.88,Transfer From Lion Pumping For last week 1/10/19,2432.37
7/10/2019,-31.45,Jaycar Electronics Thomastown AU,1379.49
5/10/2019,270,POS 43424400 05 OCT,1410.94
5/10/2019,-103.94,COSTCO WHOLESALE AUSTR EPPING AU,1140.94
5/10/2019,-1000,Transfer to xx5005 NetBank,1244.88
5/10/2019,-580,Transfer to xx4217 NetBank,2244.88
5/10/2019,-40,OZTELL SYDNEY AU Card xx8833 Value Date: 02/10/2019,2824.88
5/10/2019,-0.9,International Transaction Fee Value Date: 02/10/2019,2864.88
5/10/2019,-29.99,WHITESPARKI 5875232235 AB CA Card xx8833 USD 20.00 Value Date: 02/10/2019,2865.78
4/10/2019,455,POS 43424400 04 OCT,2895.77
4/10/2019,-217.12,COSTCO WHOLESALE AUSTR EPPING AU,2440.77
4/10/2019,-104.87,HOLLARD INSURANCE CHATSWOOD AU Card xx7776 Value Date: 01/10/2019,2657.89
3/10/2019,310,POS 43424400 03 OCT,2762.76
3/10/2019,-10.93,Direct Debit 279234 PAYPAL AUSTRALIA 1006766040568,2452.76
3/10/2019,-500,GEM VISA CARD NetBank BPAY 154799 6010732002049206,2463.69
3/10/2019,1052.88,Direct Credit 364049 LB CONCRETE JDL SOFTWARE - LB,2963.69
3/10/2019,-58,OFFICEWORKS 0340 EPPING AU,1910.81
3/10/2019,-283.6,VIC ROADS BUNDOORA BUNDOORA AU Card xx7776 Value Date: 30/09/2019,1968.81
2/10/2019,240,POS 43424400 02 OCT,2252.41
2/10/2019,-1.49,Direct Debit 279234 PAYPAL AUSTRALIA 1006753340930,2012.41
2/10/2019,-90,CBA MERCHANT FEE 5353109391629396 Value Date: 30/09/2019,2013.9
2/10/2019,-80,COSTCO WHOLESALE AUSTR EPPING AU,2103.9
1/10/2019,200,POS 43424400 01 OCT,2183.9
1/10/2019,-447.7,Transfer to CBA A/c NetBank Danibel Supplier,1983.9
1/10/2019,-75.5,SQ *J&T VASILEVSKI Preston AU Card xx8833 Value Date: 26/09/2019,2431.6
1/10/2019,-139.46,TELSTRA BILL PAYMNT MELBOURNE AU Card xx8833 Value Date: 27/09/2019,2507.1
1/10/2019,-165,MARK TRUONG PRESTON AU Card xx8833 Value Date: 26/09/2019,2646.56
1/10/2019,-200.63,OPTUS BILLING SERVICES MACQUARIE PAR AU Card xx8833 Value Date: 27/09/2019,2811.56
1/10/2019,-147,OFFICEWORKS 0340 EPPING AU Tap and Pay xx4477 Value Date: 28/09/2019,3012.19
30/09/2019,140,POS 43424400 30 SEP,3159.19
30/09/2019,-149.27,Direct Debit 466856 GIO COMMERCIAL I GPM004106253,3019.19
30/09/2019,-8.95,Direct Debit 279234 PAYPAL AUSTRALIA 1006720444335,3168.46
30/09/2019,-8,Direct Debit 279234 PAYPAL AUSTRALIA 1006720414481,3177.41
30/09/2019,-29.99,Direct Debit 279234 PAYPAL AUSTRALIA 1006728264682,3185.41
30/09/2019,750,Transfer from CBA NetBank Hallett,3215.4
30/09/2019,-1430,Aston.Commercial NetBank BPAY 81273 10165207 Rent and Rates,2465.4
29/09/2019,-127.8,INDUSTRIE CLOTHING P BUNDOORA AU,3895.4
29/09/2019,-90,STRANDBAGS 148 BUNDOORA AU Card xx8833,4023.2
29/09/2019,-20,UNITED PRESTON STH PRESTON SOUT AU,4113.2
28/09/2019,530,POS 43424400 28 SEP,4133.2
28/09/2019,-39.9,ALDI STORES - EPPING EPPING AU,3603.2
28/09/2019,-190.93,COSTCO WHOLESALE AUSTR EPPING AU,3643.1
28/09/2019,-200,Transfer to xx5005 CommBank app,3834.03
27/09/2019,190,POS 43424400 27 SEP,4034.03
27/09/2019,1052.88,Direct Credit 141000 LION PUMPING LION PUMPING,3844.03
27/09/2019,-580,Transfer to xx4217 NetBank,2791.15
26/09/2019,340,POS 43424400 26 SEP,3371.15
26/09/2019,1052.88,Direct Credit 364049 LB CONCRETE JDL SOFTWARE - LB,3031.15
26/09/2019,-85,BROADWAY COMPUTERS P RESERVOIR AU Card xx8833,1978.27
25/09/2019,175,POS 43424400 25 SEP,2063.27
25/09/2019,-56.9,Direct Debit 279234 PAYPAL AUSTRALIA 1006688040657,1888.27
24/09/2019,350,POS 43424400 24 SEP,1945.17
24/09/2019,-13.19,Direct Debit 279234 PAYPAL AUSTRALIA 1006679972683,1595.17
24/09/2019,-17.05,MCDONALDS THOMASTWNII THOMASTOWN AU Card xx8833 Value Date: 18/09/2019,1608.36
24/09/2019,-76.99,ADOBE CREATIVE CLOUD 1800614863 IE Card xx8833 AUD 76.99 Value Date: 19/09/2019,1625.41
23/09/2019,-84.73,Direct Debit 279234 PAYPAL AUSTRALIA 1006676864633,1702.4
21/09/2019,510,POS 43424400 21 SEP,1787.13
20/09/2019,90,POS 43424400 20 SEP,1277.13
20/09/2019,-79.79,Direct Debit 279234 PAYPAL AUSTRALIA 1006647615132,1187.13
20/09/2019,-709.5,Transfer to CBA A/c NetBank Danibel Supplier,1266.92
19/09/2019,150,POS 43424400 19 SEP,1976.42
19/09/2019,-49,Direct Debit 279234 PAYPAL AUSTRALIA 1006646321135,1826.42
19/09/2019,-500,Transfer to xx5005 NetBank,1875.42
19/09/2019,-580,Transfer to xx4217 NetBank,2375.42
19/09/2019,1052.88,Transfer From LION PUMP DIGI LION PUMP DIGI,2955.42
19/09/2019,1052.88,Direct Credit 364049 LB CONCRETE JDL SOFTWARE - LB,1902.54
19/09/2019,-90.52,BUNNINGS 689000 MILL PARK AU Tap and Pay xx4477 Value Date: 16/09/2019,849.66
18/09/2019,-35.09,Direct Debit 062246 CommInsure 8260620--136904730,940.18
18/09/2019,-42,THE GOOD GUYS THOMASTOWN AU,975.27
17/09/2019,400,POS 43424400 17 SEP,1017.27
17/09/2019,-55,HAT COMPUTER TECHNOLOG BUNDOORA AU Card xx8833,617.27
17/09/2019,-13.3,POST THOMASTOWN POSTTH THOMASTOWN AU Card xx7776 Value Date: 12/09/2019,672.27
16/09/2019,100,POS 43424400 16 SEP,685.57
15/09/2019,-417.48,COSTCO WHOLESALE AUSTR EPPING AU Card xx7776,585.57
15/09/2019,-203,CENTRE COM SUNSHINE AU,1003.05
15/09/2019,-319,CENTRE COM SUNSHINE SUNSHINE AU,1206.05
14/09/2019,110,POS 43424400 14 SEP,1525.05
14/09/2019,-200,Transfer to xx5005 CommBank app Wages,1415.05
14/09/2019,-99,SMP*Centrecom Bundoor Bundoora03 AU,1615.05
14/09/2019,-4.82,International Transaction Fee Value Date: 11/09/2019,1714.05
14/09/2019,-160.61,SEMRUSH.COM HTTPSWWW.SEMR PA US Card xx8833 USD 109.95 Value Date: 11/09/2019,1718.87
13/09/2019,270,POS 43424400 13 SEP,1879.48
13/09/2019,-115.94,Direct Debit 122794 IINET TECHNOLOGI 1925405fef50b35,1609.48
13/09/2019,-5.6,Direct Debit 279234 PAYPAL AUSTRALIA 1006588703304,1725.42
13/09/2019,-80,COSTCO WHOLESALE AUSTR EPPING AU,1731.02
13/09/2019,-199.76,OFFICEWORKS 0315 BUNDOORA AU,1811.02
13/09/2019,1052.88,Transfer From lion pumping Software development fee,2010.78
13/09/2019,500,Transfer From lion pumping Monthly seo lion p,957.9
13/09/2019,-557.67,Aston.Commercial NetBank BPAY 81273 10165207 Rent and Rates,457.9
13/09/2019,-580,Transfer to xx4217 NetBank,1015.57
13/09/2019,-1000,Transfer to xx5005 CommBank app Wages,1595.57
12/09/2019,440,POS 43424400 12 SEP,2595.57
12/09/2019,-72.32,Direct Debit 068616 HOLLARD INSURANC HOLLAR2518328226,2155.57
12/09/2019,-26.14,Direct Debit 279234 PAYPAL AUSTRALIA 1006587716005,2227.89
12/09/2019,1052.88,Direct Credit 364049 LB CONCRETE JDL SOFTWARE - LB,2254.03
11/09/2019,160,POS 43424400 11 SEP,1201.15
11/09/2019,-99.32,Vodafone Australia North Sydney AU Card xx8833 Value Date: 06/09/2019,1041.15
11/09/2019,-69,JB HI FI THOMASTOWN AU Card xx8833 Value Date: 06/09/2019,1140.47
10/09/2019,-4.23,Direct Debit 279234 PAYPAL AUSTRALIA 1006570237987,1209.47
9/09/2019,80,POS 43424400 09 SEP,1213.7
9/09/2019,-300,Transfer to xx5005 NetBank,1133.7
8/09/2019,-214.8,DAN MURPHYS W3073 SOUTH MORANG AU Card xx8833,1433.7
7/09/2019,400,POS 43424400 07 SEP,1648.5
6/09/2019,120,POS 43424400 06 SEP,1248.5
6/09/2019,-51.62,Direct Debit 279234 PAYPAL AUSTRALIA 1006533463270,1128.5
6/09/2019,-52,Direct Debit 279234 PAYPAL AUSTRALIA 1006533529242,1180.12
6/09/2019,-250,Transfer to xx4217 NetBank,1232.12
6/09/2019,70,Transfer from GLENN CROCKER NetBank Glenn,1482.12
5/09/2019,-580,Transfer to xx4217 NetBank,1412.12
5/09/2019,-547.53,EnergyAustralia Pty NetBank BPAY 97410 10035416593204 Electricity Shop,1992.12
5/09/2019,1052.88,Direct Credit 364049 LB CONCRETE JDL SOFTWARE - LB,2539.65
5/09/2019,-70.01,COSTCO WHOLESALE AUSTR EPPING AU,1486.77
5/09/2019,-72.03,COSTCO WHOLESALE AUSTR EPPING AU,1556.78
5/09/2019,-0.89,International Transaction Fee Value Date: 02/09/2019,1628.81
5/09/2019,-29.82,WHITESPARKI 5875232235 AB CA Card xx8833 USD 20.00 Value Date: 02/09/2019,1629.7
5/09/2019,-104.87,HOLLARD INSURANCE CHATSWOOD AU Card xx7776 Value Date: 02/09/2019,1659.52
4/09/2019,130,POS 43424400 04 SEP,1764.39
4/09/2019,-300,GEM VISA CARD NetBank BPAY 154799 6010732002049206,1634.39
4/09/2019,-1430,Aston.Commercial NetBank BPAY 81273 10165207 Rent and Rates,1934.39
4/09/2019,1052.88,Transfer From Lion Pumping Pty CREDIT TO ACCOUNT,3364.39
3/09/2019,61,POS 43424400 03 SEP,2311.51
3/09/2019,-10.81,Direct Debit 279234 PAYPAL AUSTRALIA 1006509558568,2250.51
3/09/2019,-97,WOOLWORTHS 3171 MILL PARK AU Tap and Pay xx4477 Value Date: 29/08/2019,2261.32
2/09/2019,120,POS 43424400 02 SEP,2358.32
2/09/2019,-1.49,Direct Debit 279234 PAYPAL AUSTRALIA 1006498137181,2238.32
2/09/2019,-90,CBA MERCHANT FEE 5353109391629396 Value Date: 31/08/2019,2239.81
31/08/2019,80,POS 43424400 31 AUG,2329.81
31/08/2019,-250,Transfer to xx5005 NetBank,2249.81
30/08/2019,530,POS 43424400 30 AUG,2499.81
30/08/2019,-139.46,TELSTRA BILL PAYMNT MELBOURNE AU Card xx8833 Value Date: 28/08/2019,1969.81
30/08/2019,-380.97,OPTUS BILLING SERVICES MACQUARIE PAR AU Card xx8833 Value Date: 28/08/2019,2109.27
29/08/2019,-12.99,Direct Debit 279234 PAYPAL AUSTRALIA 1006470181309,2490.24
29/08/2019,1052.88,Direct Credit 364049 LB CONCRETE JDL SOFTWARE - LB,2503.23
29/08/2019,-22.98,PLINE PH LALOR PLAZA LALOR AU Card xx8833 Value Date: 25/08/2019,1450.35
28/08/2019,60,POS 43424400 28 AUG,1473.33
28/08/2019,-149.27,Direct Debit 466856 GIO COMMERCIAL I GPM004106253,1413.33
28/08/2019,-145,SPOTLIGHT 113 MILL PARK AU Tap and Pay xx4477 Value Date: 24/08/2019,1562.6
28/08/2019,-34.95,WOOLWORTHS 3353 HEIDEL HEIDELBERG AU Tap and Pay xx4477 Value Date: 24/08/2019,1707.6
28/08/2019,-26.46,COLES 7786 LALOR AU Tap and Pay xx4477 Value Date: 26/08/2019,1742.55
28/08/2019,1052.88,Transfer From Lion Pumping Pty CREDIT TO ACCOUNT,1769.01
27/08/2019,-45.75,Direct Debit 279234 PAYPAL AUSTRALIA 1006453508343,716.13
27/08/2019,-116.74,Direct Debit 122794 IINET TECHNOLOGI 1923705f71147da,761.88
27/08/2019,-15.65,KFC EPPING EPPING AU Card xx8833,878.62
27/08/2019,-76.98,D'Amore Cellars Lalor AU Tap and Pay xx4477 Value Date: 25/08/2019,894.27
26/08/2019,280,POS 43424400 26 AUG,971.25
26/08/2019,-84.42,Direct Debit 279234 PAYPAL AUSTRALIA 1006425110865,691.25
26/08/2019,-257.79,COSTCO WHOLESALE AUSTR EPPING AU,775.67
25/08/2019,2,Refund Purchase PLINE PH LALOR PLAZA LALOR VICAU,1033.46
24/08/2019,110,POS 43424400 24 AUG,1031.46
24/08/2019,-129,THE MEAT & WINE CO HAW HAWTHORN EASTAU,921.46
24/08/2019,-101.65,COSTCO WHOLESALE AUSTR EPPING AU Card xx8833,1050.46
24/08/2019,-80,COSTCO WHOLESALE AUSTR EPPING AU,1152.11
23/08/2019,240,POS 43424400 23 AUG,1232.11
23/08/2019,-595,HARVEY NORMAN AV/IT THOMASTOWN AU,992.11
23/08/2019,750,Transfer from CBA NetBank Hallett 007HAL,1587.11
23/08/2019,-200,Transfer to xx4217 NetBank,837.11
23/08/2019,-1430,Aston.Commercial NetBank BPAY 81273 10165207 Rent and Rates,1037.11
23/08/2019,-85,ASIC SYDNEY AU Card xx8833 Value Date: 21/08/2019,2467.11
22/08/2019,1052.88,Direct Credit 364049 LB CONCRETE JDL SOFTWARE - LB,2552.11
22/08/2019,-76.99,ADOBE CREATIVE CLOUD 1800614863 IE Card xx8833 AUD 76.99 Value Date: 19/08/2019,1499.23
21/08/2019,-300,Transfer to xx5005 CommBank app Value Date: 22/08/2019,1576.22
21/08/2019,1052.88,Transfer From Lion Pumping CREDIT TO ACCOUNT,1876.22
20/08/2019,-417.4,VICROADS NetBank BPAY 216291 255871020036119 rego peugeot Value Date: 21/08/2019,823.34
20/08/2019,500,Direct Credit 141000 Lion Pumping,1240.74
20/08/2019,-35.09,Direct Debit 062246 CommInsure 8260620--136122037,740.74
19/08/2019,-55.85,Direct Debit 279234 PAYPAL AUSTRALIA 1006371458905,775.83
16/08/2019,-215.29,Direct Debit 279234 PAYPAL AUSTRALIA 1006359513895,831.68
16/08/2019,-1564,Transfer to xx5005 NetBank,1046.97
15/08/2019,1052.88,Direct Credit 364049 LB CONCRETE JDL SOFTWARE - LB,2610.97
14/08/2019,-4.87,International Transaction Fee Value Date: 11/08/2019,1558.09
14/08/2019,-162.25,SEMRUSH.COM 855-814-4510 PA US Card xx8833 USD 109.95 Value Date: 11/08/2019,1562.96
14/08/2019,1052.88,Transfer From Lion Pumping CREDIT TO ACCOUNT,1725.21
12/08/2019,-72.32,Direct Debit 068616 HOLLARD INSURANC HOLLAR2495517702,672.33
11/08/2019,-2000,Transfer to xx5005 NetBank,744.65
10/08/2019,-200,Transfer to xx4217 NetBank,2744.65
9/08/2019,1052.88,Direct Credit 364049 LB CONCRETE JDL SOFTWARE - LB,2944.65
9/08/2019,-104.31,VODAFONE NORTH SYDNEY AU Card xx8833 Value Date: 07/08/2019,1891.77
8/08/2019,-12.99,Direct Debit 279234 PAYPAL AUSTRALIA 1006295913321,1996.08
7/08/2019,1052.88,Transfer From Lion Pumping CREDIT TO ACCOUNT,2009.07
6/08/2019,-40,OZTELL SYDNEY AU Card xx8833 Value Date: 01/08/2019,956.19
6/08/2019,-0.89,International Transaction Fee Value Date: 02/08/2019,996.19
6/08/2019,-29.58,WHITESPARKI 5875232235 AB CA Card xx8833 USD 20.00 Value Date: 02/08/2019,997.08
6/08/2019,-104.87,HOLLARD INSURANCE CHATSWOOD AU Card xx7776 Value Date: 01/08/2019,1026.66
5/08/2019,-10.67,Direct Debit 279234 PAYPAL AUSTRALIA 1006259900752,1131.53
3/08/2019,-200,GEM VISA CARD NetBank BPAY 154799 6010732002049206,1142.2
2/08/2019,1052.88,Direct Credit 141000 LION PUMPING LION PUMPING,1342.2
2/08/2019,-1.49,Direct Debit 279234 PAYPAL AUSTRALIA 1006248450100,289.32
2/08/2019,-90,CBA MERCHANT FEE 5353109391629396 Value Date: 31/07/2019,290.81
1/08/2019,-21.99,Direct Debit 279234 PAYPAL AUSTRALIA 1006238340215,380.81
1/08/2019,-2000,Transfer to xx5005 CommBank app,402.8
1/08/2019,1052.88,Direct Credit 364049 LB CONCRETE JDL SOFTWARE - LB,2402.8
31/07/2019,-139.36,TELSTRA BILL PAYMNT MELBOURNE AU Card xx8833 Value Date: 27/07/2019,1349.92
31/07/2019,-109.47,OPTUS BILLING SERVICES MACQUARIE PAR AU Card xx8833 Value Date: 27/07/2019,1489.28
30/07/2019,-149.27,Direct Debit 466856 GIO COMMERCIAL I GPM004106253,1598.75
30/07/2019,-7.99,Direct Debit 279234 PAYPAL AUSTRALIA 1006222727702,1748.02
29/07/2019,-25,Direct Debit 279234 PAYPAL AUSTRALIA 1006213549426,1756.01
25/07/2019,-400,Transfer to xx4217 NetBank,1781.01
25/07/2019,1052.88,Direct Credit 141000 DRAGZ ENTERPRISE LION PUMPING,2181.01
25/07/2019,1052.88,Direct Credit 364049 LB CONCRETE JDL SOFTWARE - LB,1128.13
24/07/2019,-14.99,Direct Debit 279234 PAYPAL AUSTRALIA 1006174632222,75.25
24/07/2019,-1000,Transfer to xx5005 CommBank app,90.24
23/07/2019,-56.1,Aston.Commercial NetBank BPAY 81273 10165207 Rent and Outgoings,1090.24
23/07/2019,-76.99,ADOBE CREATIVE CLOUD 1800614863 IE Card xx8833 AUD 76.99 Value Date: 19/07/2019,1146.34
22/07/2019,500,Direct Credit 141000 Lion Pumping,1223.33
22/07/2019,-47.3,Direct Debit 279234 PAYPAL AUSTRALIA 1006152423943,723.33
22/07/2019,-103.52,Direct Debit 279234 PAYPAL AUSTRALIA 1006146152051,770.63
21/07/2019,-1000,Transfer to xx5005 CommBank app,874.15
20/07/2019,-710,Aston.Commercial NetBank BPAY 81273 10165207 Rent and Rates,1874.15
20/07/2019,800,Transfer from CBA NetBank Hallettstone,2584.15
18/07/2019,-1000,Transfer to xx5005 NetBank,1784.15
18/07/2019,-200,Transfer to xx4217 NetBank,2784.15
18/07/2019,1052.88,Direct Credit 141000 DRAGZ ENTERPRISE LION PUMPING,2984.15
18/07/2019,-35.09,Direct Debit 062246 CommInsure 8260620--135269360,1931.27
18/07/2019,1052.88,Direct Credit 364049 LB CONCRETE JDL SOFTWARE - LB,1966.36
18/07/2019,-89,JB HI FI THOMASTOWN AU Tap and Pay xx4477 Value Date: 15/07/2019,913.48
18/07/2019,-115,HARVEY NORMAN AV/IT THOMASTOWN AU Card xx8833 Value Date: 15/07/2019,1002.48
16/07/2019,-20,COSTCO WHOLESALE AUSTR EPPING AU,1117.48
16/07/2019,-4.75,International Transaction Fee Value Date: 11/07/2019,1137.48
16/07/2019,-158.19,SEMRUSH.COM HTTPSWWW.SEMR PA US Card xx8833 USD 109.95 Value Date: 11/07/2019,1142.23
15/07/2019,-141.69,Direct Debit 122794 IINET TECHNOLOGI 1919205e25c3e38,1300.42
14/07/2019,100,POS 43424400 14 JUL,1442.11
14/07/2019,400,Transfer from NetBank,1342.11
13/07/2019,330,POS 43424400 13 JUL,942.11
13/07/2019,-36.49,JB HI FI THOMASTOWN AU Card xx8833 Value Date: 09/07/2019,612.11
12/07/2019,390,POS 43424400 12 JUL,648.6
12/07/2019,-72.32,Direct Debit 068616 HOLLARD INSURANC HOLLAR2474319957,258.6
12/07/2019,100,Transfer from NetBank,330.92
12/07/2019,-10,Transfer to xx5005 NetBank,230.92
12/07/2019,-720,Aston.Commercial NetBank BPAY 81273 10165207 Rent and Rates,240.92
11/07/2019,180,POS 43424400 11 JUL,960.92
11/07/2019,-80,Transfer to xx5005 CommBank app SSL certificate,780.92
11/07/2019,-102.45,VODAFONE NORTH SYDNEY AU Card xx8833 Value Date: 09/07/2019,860.92
10/07/2019,120,POS 43424400 10 JUL,963.37
9/07/2019,230,POS 43424400 09 JUL,843.37
9/07/2019,-23.99,COSTCO WHOLESALE AUSTR EPPING AU Card xx7776,613.37
9/07/2019,23.99,Return COSTCO WHOLESALE AUSTR EPPING AU Card xx7776,637.36
9/07/2019,-99,JB HI FI THOMASTOWN AU Card xx8833 Value Date: 04/07/2019,613.37
8/07/2019,100,POS 43424400 08 JUL,712.37
6/07/2019,-80,COSTCO WHOLESALE AUSTR EPPING AU,612.37
6/07/2019,-215,WU 1918485498368425 180-017-3833 AU Card xx8833 Value Date: 03/07/2019,692.37
5/07/2019,120,POS 43424400 05 JUL,907.37
5/07/2019,-89,OFFICEWORKS 0340 EPPING AU Card xx8833 Value Date: 03/07/2019,787.37
5/07/2019,-0.86,International Transaction Fee Value Date: 02/07/2019,876.37
5/07/2019,-28.75,WHITESPARKI 8554066050 AB CA Card xx8833 USD 20.00 Value Date: 02/07/2019,877.23
4/07/2019,220,POS 43424400 04 JUL,905.98
4/07/2019,-29,Direct Debit 279234 PAYPAL AUSTRALIA 1006020737655,685.98
4/07/2019,-250,GEM VISA CARD NetBank BPAY 154799 6010732002049206,714.98
4/07/2019,-89,OFFICEWORKS 0340 EPPING AU Card xx8833 Value Date: 02/07/2019,964.98
4/07/2019,-104.87,HOLLARD INSURANCE CHATSWOOD AU Card xx7776 Value Date: 01/07/2019,1053.98
3/07/2019,490,POS 43424400 03 JUL,1158.85
3/07/2019,-10.43,Direct Debit 279234 PAYPAL AUSTRALIA 1006015385588,668.85
3/07/2019,-59.99,Direct Debit 279234 PAYPAL AUSTRALIA 1006011714401,679.28
2/07/2019,470,POS 43424400 02 JUL,739.27
2/07/2019,-1.49,Direct Debit 279234 PAYPAL AUSTRALIA 1006003688981,269.27
2/07/2019,-90,CBA MERCHANT FEE 5353109391629396 Value Date: 30/06/2019,270.76
2/07/2019,-109.11,TELSTRA BILL PAYMNT MELBOURNE AU Card xx8833 Value Date: 28/06/2019,360.76
2/07/2019,-109.48,OPTUS BILLING SERVICES MACQUARIE PAR AU Card xx8833 Value Date: 28/06/2019,469.87
2/07/2019,-7,Melb Onstreet MORELEY AU Card xx8833 Value Date: 27/06/2019,579.35
2/07/2019,-14,Melb Onstreet MORELEY AU Card xx8833 Value Date: 27/06/2019,586.35
1/07/2019,230,POS 43424400 01 JUL,600.35
1/07/2019,-0.06,Debit Excess Interest,370.35
